2013,tt1711425,21 & Over,none,notalk,FAIL,13000000,25682380,42195766,13000000,25682380,42195766,1,67878146,67878146
2012,tt1343727,Dredd 3D,disagree,ok,PASS,45000000,13414714,40868994,45658735,13611086,41467257,1,54283708,55078343
2013,tt2024544,12 Years a Slave,disagree,notalk,FAIL,20000000,53107035,158607035,20000000,53107035,158607035,1,211714070,211714070
2013,tt1272878,2 Guns,none,notalk,FAIL,61000000,75612460,132493015,61000000,75612460,132493015,1,208105475,208105475
2013,tt0453562,42,none,men,FAIL,40000000,95020213,95020213,40000000,95020213,95020213,1,190040426,190040426
2013,tt1335975,47 Ronin,none,men,FAIL,225000000,38362475,145803842,225000000,38362475,145803842,1,184166317,184166317
2013,tt1606378,A Good Day to Die Hard,none,notalk,FAIL,92000000,67349198,304249198,92000000,67349198,304249198,1,371598396,371598396
2013,tt2194499,About Time,disagree,ok,PASS,12000000,15323921,87324746,12000000,15323921,87324746,1,102648667,102648667
2013,tt1814621,Admission,none,ok,PASS,13000000,18007317,18007317,13000000,18007317,18007317,1,36014634,36014634
2013,tt1815862,After Earth,none,notalk,FAIL,130000000,60522097,244373198,130000000,60522097,244373198,1,304895295,304895295
2013,tt1800241,American Hustle,disagree,ok,PASS,40000000,148430908,249484909,40000000,148430908,249484909,1,397915817,397915817
2013,tt1322269,August: Osage County,none,ok,PASS,25000000,37304874,50304874,25000000,37304874,50304874,1,87609748,87609748
2013,tt1559547,Beautiful Creatures,none,ok,PASS,50000000,19452138,55940671,50000000,19452138,55940671,1,75392809,75392809
2013,tt2334873,Blue Jasmine,disagree,ok,PASS,18000000,33345833,68447831,18000000,33345833,68447831,1,101793664,101793664
2013,tt1535109,Captain Phillips,none,notalk,FAIL,55000000,107136417,218743570,55000000,107136417,218743570,1,325879987,325879987
2013,tt1939659,Carrie,none,ok,PASS,30000000,35266619,85001659,30000000,35266619,85001659,1,120268278,120268278
2013,tt1985966,Cloudy with a Chance of Meatballs 2,disagree,nowomen,FAIL,78000000,119640264,271725448,78000000,119640264,271725448,1,391365712,391365712
2013,tt1690953,Despicable Me 2,none,ok,PASS,76000000,368065385,970766005,76000000,368065385,970766005,1,1338831390,1338831390
2013,tt2229499,Don Jon,disagree,dubious,FAIL,5500000,24477704,26377704,5500000,24477704,26377704,1,50855408,50855408
2013,tt1535108,Elysium,disagree,ok,PASS,120000000,93050117,286192091,120000000,93050117,286192091,1,379242208,379242208
2013,tt1731141,Ender's Game,none,men,FAIL,110000000,61737191,89737191,110000000,61737191,89737191,1,151474382,151474382
2013,tt0848537,Epic,disagree,ok,PASS,100000000,107518682,268418682,100000000,107518682,268418682,1,375937364,375937364
2013,tt0765446,Escape from Planet Earth,none,ok,PASS,40000000,57012977,66454811,40000000,57012977,66454811,1,123467788,123467788
2013,tt1211956,Escape Plan,none,men,FAIL,70000000,25213103,103813103,70000000,25213103,103813103,1,129026206,129026206
2013,tt1288558,Evil Dead,disagree,ok,PASS,17000000,54239856,97402049,17000000,54239856,97402049,1,151641905,151641905
2013,tt1905041,Fast and Furious 6,disagree,ok,PASS,160000000,238679850,788128122,160000000,238679850,788128122,1,1026807972,1026807972
2013,tt2294629,Frozen,none,ok,PASS,150000000,393050114,1004550114,150000000,393050114,1004550114,1,1397600228,1397600228
2013,tt1583421,G.I. Joe: Retaliation,disagree,ok,PASS,140000000,122523060,371923060,140000000,122523060,371923060,1,494446120,494446120
2013,tt1321870,Gangster Squad,none,notalk,FAIL,60000000,46000903,104100903,60000000,46000903,104100903,1,150101806,150101806
2013,tt2425486,Gloria,none,ok,PASS,30000000,4167493,4967493,30000000,4167493,4967493,1,9134986,9134986
2013,tt1454468,Gravity,disagree,nowomen,FAIL,110000000,271814796,708714796,110000000,271814796,708714796,1,980529592,980529592
2013,tt2191701,Grown Ups 2,disagree,men,FAIL,80000000,133668525,247023808,80000000,133668525,247023808,1,380692333,380692333
2013,tt1428538,Hansel & Gretel: Witch Hunters,none,ok,PASS,50000000,55703475,225703475,50000000,55703475,225703475,1,281406950,281406950
2013,tt1798709,Her,disagree,men,FAIL,23000000,25000178,33029713,23000000,25000178,33029713,1,58029891,58029891
2013,tt2024432,Identity Thief,disagree,men,FAIL,35000000,134506920,176269721,35000000,134506920,176269721,1,310776641,310776641
2013,tt2226417,Insidious: Chapter 2,none,men,FAIL,5000000,83586447,161911222,5000000,83586447,161911222,1,245497669,245497669
2013,tt1300854,Iron Man 3,disagree,dubious,FAIL,200000000,408992272,1212692272,200000000,408992272,1212692272,1,1621684544,1621684544
2013,tt1351685,Jack the Giant Slayer,disagree,nowomen,FAIL,195000000,65187603,197387603,195000000,65187603,197387603,1,262575206,262575206
2013,tt1650554,Kick-Ass 2,none,ok,PASS,28000000,28795985,60839197,28000000,28795985,60839197,1,89635182,89635182
2013,tt1204975,Last Vegas,none,notalk,FAIL,28000000,63914167,112914167,28000000,63914167,112914167,1,176828334,176828334
2013,tt1327773,Lee Daniels' The Butler,none,ok,PASS,30000000,116632095,151513429,30000000,116632095,151513429,1,268145524,268145524
2013,tt2002718,Machete Kills,none,ok,PASS,2000000,8008161,9408161,2000000,8008161,9408161,1,17416322,17416322
2013,tt2023587,Mama,none,ok,PASS,15000000,71628180,148041253,15000000,71628180,148041253,1,219669433,219669433
2013,tt0770828,Man of Steel,disagree,ok,PASS,225000000,291045518,687999518,225000000,291045518,687999518,1,979045036,979045036
2013,tt1821549,Nebraska,disagree,ok,PASS,12000000,17482517,17482517,12000000,17482517,17482517,1,34965034,34965034
2013,tt1670345,Now You See Me,disagree,notalk,FAIL,75000000,117723989,351723989,75000000,117723989,351723989,1,469447978,469447978
2013,tt1483013,Oblivion,disagree,men,FAIL,120000000,89107235,287537983,120000000,89107235,287537983,1,376645218,376645218
2013,tt2302755,Olympus Has Fallen,none,notalk,FAIL,70000000,98927592,150562164,70000000,98927592,150562164,1,249489756,249489756
2013,tt1623205,Oz the Great and Powerful,disagree,ok,PASS,200000000,234770996,489570996,200000000,234770996,489570996,1,724341992,724341992
2013,tt1663662,Pacific Rim,disagree,notalk,FAIL,190000000,101802906,411002906,190000000,101802906,411002906,1,512805812,512805812
2013,tt1980209,Pain & Gain,none,notalk,FAIL,26000000,49875291,81275291,26000000,49875291,81275291,1,131150582,131150582
2013,tt1904996,Parker,none,ok,PASS,35000000,17616641,46346651,35000000,17616641,46346651,1,63963292,63963292
2013,tt1699755,Peeples,none,dubious,FAIL,15000000,9177065,9177065,15000000,9177065,9177065,1,18354130,18354130
2013,tt1854564,Percy Jackson: Sea of Monsters,none,ok,PASS,90000000,68559554,200859554,90000000,68559554,200859554,1,269419108,269419108
2013,tt1392214,Prisoners,none,ok,PASS,46000000,61002302,113402302,46000000,61002302,113402302,1,174404604,174404604
2013,tt0790736,R.I.P.D.,none,notalk,FAIL,130000000,33618855,79019947,130000000,33618855,79019947,1,112638802,112638802
2013,tt1821694,Red 2,none,ok,PASS,84000000,53262560,137162560,84000000,53262560,137162560,1,190425120,190425120
2013,tt1411250,Riddick,disagree,notalk,FAIL,38000000,42025135,92425135,38000000,42025135,92425135,1,134450270,134450270
2013,tt2364841,Runner Runner,none,nowomen,FAIL,30000000,19316646,62616646,30000000,19316646,62616646,1,81933292,81933292
2013,tt1979320,Rush,none,notalk,FAIL,38000000,26947624,43047624,38000000,26947624,43047624,1,69995248,69995248
2013,tt1702439,Safe Haven,none,ok,PASS,28000000,71399120,93943623,28000000,71399120,93943623,1,165342743,165342743
2013,tt2140373,Saving Mr. Banks,none,ok,PASS,35000000,82834332,100734332,35000000,82834332,100734332,1,183568664,183568664
2013,tt2053463,Side Effects,none,ok,PASS,30000000,32172757,60288363,30000000,32172757,60288363,1,92461120,92461120
2013,tt1408101,Star Trek Into Darkness,disagree,notalk,FAIL,190000000,228778661,466978661,190000000,228778661,466978661,1,695757322,695757322
2013,tt1572315,Texas Chainsaw 3D,disagree,ok,PASS,20000000,34341945,39093317,20000000,34341945,39093317,1,73435262,73435262
2013,tt1931435,The Big Wedding,none,ok,PASS,32500000,21819348,35770721,32500000,21819348,35770721,1,57590069,57590069
2013,tt0816442,The Book Thief,none,ok,PASS,19000000,21345525,62045525,19000000,21345525,62045525,1,83391050,83391050
2013,tt1911644,The Call,none,ok,PASS,13000000,51872378,58938768,13000000,51872378,58938768,1,110811146,110811146
2013,tt1457767,The Conjuring,none,ok,PASS,20000000,137400141,318000141,20000000,137400141,318000141,1,455400282,455400282
2013,tt2193215,The Counselor,none,ok,PASS,25000000,16973715,70373715,25000000,16973715,70373715,1,87347430,87347430
2013,tt0481499,The Croods,disagree,men,FAIL,135000000,187168425,573068425,135000000,187168425,573068425,1,760236850,760236850
2013,tt2404311,The Family,none,men,FAIL,30000000,36918811,51078541,30000000,36918811,51078541,1,87997352,87997352
2013,tt1837703,The Fifth Estate,none,notalk,FAIL,26000000,3254172,6154172,26000000,3254172,6154172,1,9408344,9408344
2013,tt2005374,The Frozen Ground,disagree,nowomen,FAIL,19200000,,,19200000,,,1,,
2013,tt1343092,The Great Gatsby,none,dubious,FAIL,190000000,144840419,351040419,190000000,144840419,351040419,1,495880838,495880838
2013,tt1951261,The Hangover part 3,none,men,FAIL,103000000,112200072,362000072,103000000,112200072,362000072,1,474200144,474200144
2013,tt2404463,The Heat,none,ok,PASS,43000000,159581587,230781587,43000000,159581587,230781587,1,390363174,390363174
2013,tt1170358,The Hobbit: The Desolation of Smaug,disagree,notalk,FAIL,250000000,257397516,937397516,250000000,257397516,937397516,1,1194795032,1194795032
2013,tt1517260,The Host,disagree,dubious,FAIL,50000000,26623701,58188384,50000000,26623701,58188384,1,84812085,84812085
2013,tt1951264,The Hunger Games: Catching Fire,none,ok,PASS,130000000,424088260,857088260,130000000,424088260,857088260,1,1281176520,1281176520
2013,tt0790628,The Incredible Burt Wonderstone,none,notalk,FAIL,32000000,22537881,24255957,32000000,22537881,24255957,1,46793838,46793838
2013,tt2234155,The Internship,none,notalk,FAIL,58000000,44672764,93672764,58000000,44672764,93672764,1,138345528,138345528
2013,tt2034139,The Last Exorcism Part II,none,ok,PASS,4000000,15179303,18541236,4000000,15179303,18541236,1,33720539,33720539
2013,tt1210819,The Lone Ranger,none,notalk,FAIL,275000000,89289910,259989910,275000000,89289910,259989910,1,349279820,349279820
2013,tt1538403,The Mortal Instruments: City of Bones,disagree,ok,PASS,60000000,31165421,75965567,60000000,31165421,75965567,1,107130988,107130988
2013,tt2184339,The Purge,none,dubious,FAIL,3000000,64473115,91100541,3000000,64473115,91100541,1,155573656,155573656
2013,tt2017020,The Smurfs 2,none,ok,PASS,110000000,71017784,348545841,110000000,71017784,348545841,1,419563625,419563625
2013,tt1758795,The To Do List,none,ok,PASS,1500000,3491669,3491669,1500000,3491669,3491669,1,6983338,6983338
2013,tt1727388,The Way Way Back,disagree,ok,PASS,5000000,21502690,26161443,5000000,21502690,26161443,1,47664133,47664133
2013,tt0993846,The Wolf of Wall Street,disagree,notalk,FAIL,100000000,115702857,365702857,100000000,115702857,365702857,1,481405714,481405714
2013,tt1430132,The Wolverine,none,ok,PASS,115000000,132556852,416456852,115000000,132556852,416456852,1,549013704,549013704
2013,tt1213663,The World's End,disagree,men,FAIL,20000000,26004851,46578821,20000000,26004851,46578821,1,72583672,72583672
2013,tt1245492,This Is the End,none,notalk,FAIL,32000000,101470202,126294264,32000000,101470202,126294264,1,227764466,227764466
2013,tt1981115,Thor: The Dark World,disagree,dubious,FAIL,170000000,204674790,631674790,170000000,204674790,631674790,1,836349580,836349580
2013,tt1924429,Trance,none,nowomen,FAIL,16000000,2322593,22594052,16000000,2322593,22594052,1,24916645,24916645
2013,tt1860353,Turbo,disagree,dubious,FAIL,135000000,83028130,283828130,135000000,83028130,283828130,1,366856260,366856260
2013,tt1588173,Warm Bodies,disagree,men,FAIL,30000000,66380662,116643610,30000000,66380662,116643610,1,183024272,183024272
2013,tt1723121,We're the Millers,none,ok,PASS,37000000,150394119,270000119,37000000,150394119,270000119,1,420394238,420394238
2013,tt2334879,White House Down,none,men,FAIL,150000000,73103784,205440387,150000000,73103784,205440387,1,278544171,278544171
2013,tt0816711,World War Z,disagree,dubious,FAIL,190000000,202359711,539559711,190000000,202359711,539559711,1,741919422,741919422
2012,tt1611224,Abraham Lincoln: Vampire Hunter,disagree,dubious,FAIL,67500000,37519139,115119139,68488103,38068365,116804318,1,152638278,154872683
2012,tt1591479,Act of Valor,none,nowomen,FAIL,12000000,70012847,82497035,12175663,71037735,83704673,1,152509882,154742408
2012,tt1602620,Amour,disagree,dubious,FAIL,9700000,6738954,25915719,9841994,6837603,26295088,1,32654673,33132691
2012,tt1781769,Anna Karenina,disagree,men,FAIL,49000000,12816367,70735540,49717290,13003980,71771007,1,83551907,84774987
2012,tt1024648,Argo,disagree,ok,PASS,44500000,136025503,221300694,45151416,138016721,224540219,1,357326197,362556940
2012,tt1440129,Battleship,disagree,notalk,FAIL,209000000,65235400,304142720,212059460,66190353,308594933,1,369378120,374785286
2012,tt2125435,Beasts of the Southern Wild,disagree,dubious,FAIL,1800000,12795746,21080058,1826349,12983057,21388640,1,33875804,34371697
2012,tt1758575,Blue Like Jazz,none,ok,PASS,1200000,595018,595018,1217566,603728,603728,1,1190036,1207456
2012,tt1217209,Brave,none,ok,PASS,185000000,237282182,554606532,187708135,240755653,562725176,1,791888714,803480829
2012,tt1308729,Bullet to the Head,none,nowomen,FAIL,55000000,9489829,13561515,55805121,9628746,13760036,1,23051344,23388782
2012,tt1991245,Chernobyl Diaries,none,notalk,FAIL,1000000,18119640,38390020,1014639,18384886,38951995,1,56509660,57336881
2012,tt1706593,Chronicle,none,notalk,FAIL,12000000,64575175,127075175,12175663,65520463,128935373,1,191650350,194455836
2012,tt1371111,Cloud Atlas,none,ok,PASS,102000000,27108272,126018564,103493134,27505098,127863295,1,153126836,155368393
2012,tt1524137,Contraband,none,ok,PASS,25000000,66528000,98406855,25365964,67501874,99847390,1,164934855,167349264
2012,tt1853728,Django Unchained,disagree,notalk,FAIL,100000000,162805434,425373688,101463857,165188672,431600549,1,588179122,596789221
2012,tt1907668,Flight,disagree,dubious,FAIL,31000000,93772375,161772375,31453796,95145068,164140491,1,255544750,259285559
2012,tt1142977,Frankenweenie,disagree,nowomen,FAIL,39000000,35287788,81150788,39570904,35804351,82338719,1,116438576,118143070
2012,tt2243973,Hannibal,none,ok,PASS,87000000,165092266,350100280,88273555,167508980,355225246,1,515192546,522734226
2012,tt0837562,Hotel Transylvania,none,ok,PASS,85000000,148313048,359222014,86244278,150484138,364480509,1,507535062,514964647
2012,tt0790724,Jack Reacher,none,notalk,FAIL,60000000,80070736,217370736,60878314,81242857,220552732,1,297441472,301795589
2012,tt2106476,Jagten,none,men,FAIL,3450000,687185,687185,3500503,697244,697244,1,1374370,1394488
2012,tt0401729,John Carter,disagree,ok,PASS,275000000,73058679,282778100,279025606,74128153,286917566,1,355836779,361045719
2012,tt1764234,Killing Them Softly,none,nowomen,FAIL,15000000,14945541,37238774,15219578,15164322,37783896,1,52184315,52948218
2012,tt1707386,Les Miserables,disagree,ok,PASS,65000000,148809770,442022894,65951507,150988132,448493475,1,590832664,599481607
2012,tt0454876,Life of Pi,disagree,notalk,FAIL,120000000,124987022,607987022,121756628,126816653,616887080,1,732974044,743703733
2012,tt0443272,Lincoln,disagree,ok,PASS,65000000,182207973,273000960,65951507,184875236,276997302,1,455208933,461872538
2012,tt1277953,Madagascar 3: Europe's Most Wanted,disagree,men,FAIL,145000000,216391482,746921271,147122592,219559143,757855127,1,963312753,977414270
2012,tt1409024,Men in Black III,none,notalk,FAIL,215000000,179020854,624821154,218147292,181641463,633967639,1,803842008,815609102
2012,tt1667353,Mirror Mirror,none,dubious,FAIL,85000000,64935167,168611991,86244278,65885725,171080229,1,233547158,236965954
2012,tt1748122,Moonrise Kingdom,none,ok,PASS,16000000,45512466,64012466,16234217,46178703,64949517,1,109524932,111128220
2012,tt2094064,Much Ado About Nothing,disagree,dubious,FAIL,8000000,22549338,22549338,8117109,22879428,22879428,1,45098676,45758856
2012,tt1598828,One for the Money,none,ok,PASS,42000000,26414527,36197221,42614820,26801198,36727096,1,62611748,63528294
2012,tt2109184,Paranormal Activity 4,none,ok,PASS,5000000,53900335,142793842,5073193,54689359,144884139,1,196694177,199573498
2012,tt1623288,ParaNorman,disagree,notalk,FAIL,60000000,56003051,108159011,60878314,56822855,109742304,1,164162062,166565159
2012,tt1047540,Parental Guidance,none,ok,PASS,25000000,77267296,120168633,25365964,78398378,121927729,1,197435929,200326107
2012,tt1716777,People Like Us,none,ok,PASS,16000000,12431792,12431792,16234217,12613776,12613776,1,24863584,25227552
2012,tt1981677,Pitch Perfect,none,ok,PASS,17000000,65001093,115331177,17248856,65952616,117019460,1,180332270,182972076
2012,tt1547234,Premium Rush,none,ok,PASS,35000000,20275446,31393201,35512350,20572249,31852752,1,51668647,52425001
2012,tt1234719,Red Dawn,disagree,notalk,FAIL,65000000,44806783,48164150,65951507,45462690,48869204,1,92970933,94331894
2012,tt0485985,Red Tails,none,men,FAIL,58000000,49876377,50365498,58849037,50606496,51102777,1,100241875,101709273
2012,tt1446192,Rise of the Guardians,disagree,notalk,FAIL,145000000,103412758,306900902,147122592,104926572,311393491,1,410313660,416320063
2012,tt1336608,Rock of Ages,none,ok,PASS,70000000,38518613,50118613,71024700,39082470,50852278,1,88637226,89934748
2012,tt1656190,Safe,disagree,notalk,FAIL,33000000,17142080,41495213,33483073,17393015,42102643,1,58637293,59495658
2012,tt1862079,Safety Not Guaranteed,disagree,ok,PASS,750000,4010957,4413188,760979,4069672,4477791,1,8424145,8547463
2012,tt1931533,Seven Psychopaths,disagree,notalk,FAIL,13500000,15024049,23492318,13697621,15243980,23836212,1,38516367,39080192
2012,tt0938330,Silent Hill: Revelation 3D,none,ok,PASS,20000000,17530219,47944599,20292771,17786836,48646439,1,65474818,66433275
2012,tt1045658,Silver Linings Playbook,none,ok,PASS,21000000,132092958,227317397,21307410,134026609,230644998,1,359410355,364671607
2012,tt1922777,Sinister,none,men,FAIL,3000000,48086903,87727807,3043916,48790826,89012016,1,135814710,137802842
2012,tt1074638,Skyfall,disagree,dubious,FAIL,200000000,304360277,1108694081,202927713,308815675,1124923772,1,1413054358,1433739447
2012,tt1735898,Snow White and the Huntsman,none,ok,PASS,170000000,155136755,400911200,172488556,157407735,406779965,1,556047955,564187700
2012,tt1876451,Sparkle,none,ok,PASS,10000000,24397469,24660323,10146386,24754613,25021315,1,49057792,49775928
2012,tt2101441,Spring Breakers,none,ok,PASS,5000000,14124286,30669531,5073193,14331045,31118489,1,44793817,45449534
2012,tt1800741,Step Up Revolution,none,ok,PASS,33000000,35074677,165552290,33483073,35588120,167975738,1,200626967,203563858
2012,tt1874789,Supporting Characters,none,men,FAIL,60000,4917,4917,60878,4989,4989,1,9834,9978
2012,tt1637725,Ted,disagree,men,FAIL,50000000,218665740,549444574,50731928,221866693,557487654,1,768110314,779354347
2012,tt1232200,That's My Boy,none,notalk,FAIL,67500000,36931089,58058367,68488103,37471707,58908258,1,94989456,96379965
2012,tt0948470,The Amazing Spider-Man,disagree,men,FAIL,220000000,262030663,757890267,223220484,265866416,768984693,1,1019920930,1034851109
2012,tt0848228,The Avengers,none,notalk,FAIL,60000000,23385416,48585416,60878314,23727745,49296637,1,71970832,73024382
2012,tt1345836,The Dark Knight Rises,disagree,notalk,FAIL,275000000,448139099,1079343943,279025606,454699213,1095143990,1,1527483042,1549843203
2012,tt1560985,The Devil Inside,disagree,ok,PASS,1000000,53261944,101758489,1014639,54041622,103248087,1,155020433,157289709
2012,tt1645170,The Dictator,none,notalk,FAIL,65000000,59650222,179379532,65951507,60523416,182005391,1,239029754,242528807
2012,tt1764651,The Expendables 2,disagree,ok,PASS,100000000,85028192,311979256,101463857,86272883,316546185,1,397007448,402819068
2012,tt1601913,The Grey,disagree,nowomen,FAIL,25000000,51580136,84339696,25365964,52335195,85574308,1,135919832,137909503
2012,tt0903624,The Hobbit: An Unexpected Journey,disagree,nowomen,FAIL,250000000,303003568,1014703568,253659641,307439106,1029557373,1,1317707136,1336996479
2012,tt1392170,The Hunger Games,disagree,ok,PASS,80000000,408010692,684510692,81171085,413983383,694530947,1,1092521384,1108514330
2012,tt1649419,The Impossible,none,men,FAIL,40000000,19019882,169590606,40585543,19298306,172073169,1,188610488,191371475
2012,tt1258972,The Man with the Iron Fists,none,notalk,FAIL,15000000,15634090,21985095,15219578,15862951,22306925,1,37619185,38169876
2012,tt1560747,The Master,disagree,notalk,FAIL,37500000,16247159,25116740,38048946,16484994,25484413,1,41363899,41969407
2012,tt1430626,The Pirates! Band of Misfits,none,notalk,FAIL,55000000,31051126,123056220,55805121,31505670,124857587,1,154107346,156363257
2012,tt1817273,The Place Beyond the Pines,disagree,notalk,FAIL,15000000,21403519,47011449,15219578,21716836,47699629,1,68414968,69416465
2012,tt1673434,The Twilight Saga: Breaking Dawn - Part 2,disagree,dubious,FAIL,136200000,292324737,832660037,138193773,296603952,844848985,1,1124984774,1141452937
2012,tt1606389,The Vow,none,ok,PASS,8738320,125014030,197618160,8866236,126844056,200511006,1,322632190,327355062
2012,tt1298649,The Watch,none,men,FAIL,55000000,34353000,67353000,55805121,34855879,68338951,1,101706000,103194830
2012,tt1596365,The Woman in Black,none,notalk,FAIL,15000000,54333290,128955898,15219578,55128651,130843627,1,183289188,185972278
2012,tt1840417,The Words,none,notalk,FAIL,6000000,11494838,12132578,6087831,11663106,12310182,1,23627416,23973288
2012,tt1621045,Think Like a Man,none,ok,PASS,12000000,91547205,96155124,12175663,92887325,97562697,1,187702329,190450022
2012,tt1859650,To Rome With Love,disagree,men,FAIL,21500000,16684352,74363777,21814729,16928587,75452356,1,91048129,92380943
2012,tt1386703,Total Recall,disagree,notalk,FAIL,125000000,58877969,198615996,126829821,59739858,201523449,1,257493965,261263307
2012,tt1496025,Underworld: Awakening,none,ok,PASS,70000000,62321039,160379930,71024700,63233330,162727662,1,222700969,225960992
2012,tt1655460,Wanderlust,none,ok,PASS,32500000,17288155,24159934,32975753,17541229,24513601,1,41448089,42054830
2012,tt1586265,What to Expect When You're Expecting,none,ok,PASS,37500000,41152203,80652203,38048946,41754612,81832836,1,121804406,123587448
2012,tt1870529,Won't Back Down,none,ok,PASS,19000000,5310554,5431486,19278133,5388293,5510995,1,10742040,10899288
2012,tt1646987,Wrath of the Titans,disagree,notalk,FAIL,150000000,83670083,301970083,152195785,84894893,306390492,1,385640166,391285385
2012,tt1772341,Wreck-It Ralph,disagree,ok,PASS,165000000,189412677,473412677,167415363,192185407,480342759,1,662825354,672528166
2012,tt1790885,Zero Dark Thirty,disagree,ok,PASS,52500000,95720716,137720716,53268525,97121930,139736750,1,233441432,236858680
2011,tt1622547,30 Minutes or Less,none,notalk,FAIL,28000000,37053924,40966716,28999342,38376408,42428850,1,78020640,80805258
2011,tt1306980,50/50,disagree,men,FAIL,8000000,35016118,41334735,8285526,36265871,42810004,1,76350853,79075875
2011,tt1571222,A Dangerous Method,none,dubious,FAIL,20000000,5702083,14807531,20713816,5905595,15336023,1,20509614,21241618
2011,tt1422136,A Lonely Place to Die,none,ok,PASS,4000000,,442550,4142763,,458345,1,,
2011,tt1268799,A Very Harold & Kumar 3D Christmas,none,notalk,FAIL,20000000,35061031,36265745,20713816,36312387,37560098,1,71326776,73872485
2011,tt1549572,Another Earth,none,ok,PASS,175000,1321194,1781194,181246,1368348,1844766,1,3102388,3213114
2011,tt1772240,Apollo 18,none,nowomen,FAIL,5000000,17686929,26517819,5178454,18318189,27464261,1,44204748,45782450
2011,tt1430607,Arthur Christmas,none,notalk,FAIL,85000000,46462469,147624649,88033717,48120751,152893489,1,194087118,201014240
2011,tt1478964,Attack the Block,disagree,ok,PASS,13000000,1024175,5406422,13463980,1060729,5599381,1,6430597,6660110
2011,tt1284575,Bad Teacher,disagree,ok,PASS,19000000,100292856,216412265,19678125,103872387,224136189,1,316705121,328008576
2011,tt1217613,Battle: Los Angeles,disagree,notalk,FAIL,70000000,83552429,212005201,72498355,86534481,219571833,1,295557630,306106314
2011,tt1152398,Beastly,none,notalk,FAIL,17000000,27865571,38028230,17606743,28860115,39385487,1,65893801,68245602
2011,tt1629705,Blackthorn,none,notalk,FAIL,4500000,200558,1249765,4660609,207716,1294370,1,1450323,1502086
2011,tt1478338,Bridesmaids,disagree,ok,PASS,32500000,169106725,289263136,33659951,175142277,299587165,1,458369861,474729442
2011,tt0458339,Captain America: The First Avenger,disagree,notalk,FAIL,140000000,176654505,370569776,144996710,182959443,383795703,1,547224281,566755146
2011,tt1216475,Cars 2,none,men,FAIL,200000000,191450875,560155383,207138157,198283907,580147769,1,751606258,778431676
2011,tt1684628,Circumstance,none,ok,PASS,900000,454121,454121,932122,470329,470329,1,908242,940658
2011,tt1657507,Colombiana,none,notalk,FAIL,40000000,36665854,71698079,41427631,37974487,74257040,1,108363933,112231527
2011,tt0816462,Conan the Barbarian,disagree,dubious,FAIL,20000000,38264085,79114085,20713816,39629760,81937729,1,117378170,121567489
2011,tt1598778,Contagion,disagree,ok,PASS,60000000,75658097,137551594,62141447,78358394,142460919,1,213209691,220819313
2011,tt1372686,Coriolanus,none,men,FAIL,10000000,749641,1049641,10356908,776396,1087104,1,1799282,1863500
2011,tt0409847,Cowboys & Aliens,none,notalk,FAIL,163000000,100240551,175910315,168817598,103818215,182188693,1,276150866,286006908
2011,tt1701990,Detention,none,ok,PASS,10000000,,,10356908,,,1,,
2011,tt1650043,Diary of a Wimpy Kid: Rodrick Rules,none,notalk,FAIL,18000000,52698535,73695194,18642434,54579387,76325433,1,126393729,130904820
2011,tt1564349,Dolphin Tale,none,men,FAIL,37000000,72286779,96068724,38320559,74866751,99497492,1,168355503,174364243
2011,tt1462041,Dream House,none,ok,PASS,50000000,21302340,39932340,51784539,22062637,41357557,1,61234680,63420194
2011,tt0780504,Drive,disagree,dubious,FAIL,15000000,35060689,78054825,15535362,36312033,80840663,1,113115514,117152696
2011,tt1596343,Fast Five,disagree,ok,PASS,125000000,209837675,629841284,129461348,217326947,652320815,1,839678959,869647762
2011,tt1622979,Final Destination 5,none,men,FAIL,40000000,42587643,157887643,41427631,44107629,163522777,1,200475286,207630406
2011,tt1068242,Footloose,none,ok,PASS,24000000,51802742,63412773,24856579,53651623,65676025,1,115215515,119327648
2011,tt1438176,Fright Night,none,dubious,FAIL,30000000,18298649,40520649,31070724,18951742,41966863,1,58819298,60918605
2011,tt1133985,Green Lantern,disagree,notalk,FAIL,200000000,116601172,231201172,207138157,120762760,239452924,1,347802344,360215684
2011,tt0480687,Hall Pass,none,men,FAIL,36000000,45060734,83693266,37284868,46668987,86680344,1,128754000,133349331
2011,tt0993842,Hanna,none,ok,PASS,30000000,40259119,65343694,31070724,41695999,67675862,1,105602813,109371861
2011,tt1201607,Harry Potter and the Deathly Hallows: Part 2,disagree,notalk,FAIL,125000000,381011219,1328111219,129461348,394609809,1375512553,1,1709122438,1770122362
2011,tt1506999,Haywire,disagree,nowomen,FAIL,23000000,18942396,22176190,23820888,19618465,22967676,1,41118586,42586141
2011,tt1403177,Hesher,none,notalk,FAIL,7000000,382946,382946,7249836,396614,396614,1,765892,793228
2011,tt1562568,Higher Ground,none,ok,PASS,1800000,841056,859182,1864243,871074,889847,1,1700238,1760921
2011,tt1640459,Hobo with a Shotgun,none,nowomen,FAIL,3000000,703372,834953,3107072,728476,864753,1,1538325,1593229
2011,tt1411704,Hop,none,men,FAIL,63000000,108085305,184924333,65248520,111942955,191524428,1,293009638,303467383
2011,tt1499658,Horrible Bosses,none,ok,PASS,35000000,117538559,214538559,36249178,121733603,222195609,1,332077118,343929212
2011,tt0970179,Hugo,none,dubious,FAIL,180000000,73864507,185033215,186424342,76500789,191637196,1,258897722,268137985
2011,tt1464540,I Am Number Four,none,notalk,FAIL,50000000,55100437,145982797,51784539,57067015,151193038,1,201083234,208260053
2011,tt1253864,Immortals,none,men,FAIL,75000000,83504017,211562435,77676809,86484341,219113265,1,295066452,305597606
2011,tt1637688,In Time,none,notalk,FAIL,35000000,37553932,170064664,36249178,38894261,176134406,1,207618596,215028667
2011,tt1606618,Iris,none,ok,PASS,5500000,5580479,15155021,5696299,5779651,15695916,1,20735500,21475567
2011,tt1410063,Jin ling shi san chai,none,ok,PASS,100000000,311434,93721434,103569079,322549,97066426,1,94032868,97388975
2011,tt1634122,Johnny English Reborn,none,dubious,FAIL,45000000,8305970,164539660,46606085,8602417,170412210,1,172845630,179014627
2011,tt1640484,Jumping the Broom,none,ok,PASS,7000000,37295394,38158601,7249836,38626496,39520511,1,75453995,78147007
2011,tt1564367,Just Go with It,none,dubious,FAIL,80000000,103028109,214974953,82855263,106705263,222647578,1,318003062,329352841
2011,tt1788391,Kill List,none,dubious,FAIL,800000,29063,462206,828553,30100,478703,1,491269,508803
2011,tt1448755,Killer Elite,none,nowomen,FAIL,70000000,25124986,57777106,72498355,26021717,59839216,1,82902092,85860933
2011,tt1302011,Kung Fu Panda 2,none,ok,PASS,150000000,165249063,664837547,155353618,171146932,688566122,1,830086610,859713054
2011,tt1508675,Le Havre,none,dubious,FAIL,5500000,611709,13480196,5696299,633541,13961315,1,14091905,14594856
2011,tt1758692,Like Crazy,disagree,ok,PASS,250000,3395391,3731489,258923,3516575,3864669,1,7126880,7381244
2011,tt1219289,Limitless,none,notalk,FAIL,27000000,79249455,169739455,27963651,82077930,175797590,1,248988910,257875520
2011,tt0466893,Margaret,none,ok,PASS,14000000,47185,47185,14499671,48869,48869,1,94370,97738
2011,tt1615147,Margin Call,disagree,notalk,FAIL,3400000,5353586,17872206,3521349,5544660,18510079,1,23225792,24054739
2011,tt1305591,Mars Needs Moms,none,dubious,FAIL,150000000,21392758,39549758,155353618,22156282,40961320,1,60942516,63117602
2011,tt1441326,Martha Marcy May Marlene,none,ok,PASS,1000000,2981038,3531038,1035691,3087434,3657064,1,6512076,6744498
2011,tt1527186,Melancholia,none,ok,PASS,9400000,3030848,18044073,9735493,3139021,18688080,1,21074921,21827101
2011,tt1605783,Midnight in Paris,none,ok,PASS,30000000,56816662,154816662,31070724,58844493,160342190,1,211633324,219186683
2011,tt1229238,Mission: Impossible - Ghost Protocol,disagree,notalk,FAIL,145000000,209397903,694713230,150175164,216871479,719508092,1,904111133,936379571
2011,tt1210166,Moneyball,none,notalk,FAIL,50000000,75605492,111174374,51784539,78303911,115142275,1,186779866,193446186
2011,tt1396218,Mr. Popper's Penguins,none,notalk,FAIL,55000000,68224452,189624452,56962993,70659436,196392298,1,257848904,267051734
2011,tt1598822,New Year's Eve,none,ok,PASS,26000000,54544638,143663899,26927960,56491379,148791377,1,198208537,205282756
2011,tt1411238,No Strings Attached,none,ok,PASS,25000000,70662220,149228078,25892270,73184210,154554145,1,219890298,227738355
2011,tt1720182,October Baby,none,ok,PASS,1000000,5355847,5355847,1035691,5547001,5547001,1,10711694,11094002
2011,tt1637706,Our Idiot Brother,none,ok,PASS,5000000,24814830,25861249,5178454,25700491,26784257,1,50676079,52484748
2011,tt1778304,Paranormal Activity 3,none,ok,PASS,5000000,104028807,207039844,5178454,107741677,214429259,1,311068651,322170936
2011,tt1092026,Paul,none,ok,PASS,40000000,37412945,100179814,41427631,38748242,103755310,1,137592759,142503552
2011,tt1298650,Pirates of the Caribbean: On Stranger Tides,none,notalk,FAIL,250000000,241063875,1043663875,258922697,249667634,1080913060,1,1284727750,1330580694
2011,tt0822847,Priest,disagree,notalk,FAIL,60000000,29136626,84154026,62141447,30176535,87157549,1,113290652,117334084
2011,tt0448694,Puss in Boots,none,notalk,FAIL,130000000,149260504,554987477,134639802,154587729,574795417,1,704247981,729383146
2011,tt1192628,Rango,disagree,notalk,FAIL,135000000,123257581,245504574,139818256,127656741,254266825,1,368762155,381923566
2011,tt0433035,Real Steel,none,notalk,FAIL,110000000,85463309,293237309,113925987,88513562,303703179,1,378700618,392216741
2011,tt1486185,Red Riding Hood,none,ok,PASS,42000000,37662162,90300442,43499013,39006354,93523336,1,127962604,132529690
2011,tt0873886,Red State,none,ok,PASS,4000000,1065429,1065429,4142763,1103455,1103455,1,2130858,2206910
2011,tt1498569,Restless,none,ok,PASS,8000000,163753,2818394,8285526,169597,2918985,1,2982147,3088582
2011,tt1436562,Rio,none,notalk,FAIL,90000000,143619809,487519809,93212171,148745713,504919774,1,631139618,653665487
2011,tt1318514,Rise of the Planet of the Apes,none,notalk,FAIL,93000000,176760185,482860185,96319243,183068895,500093845,1,659620370,683162740
2011,tt1723811,Shame,none,notalk,FAIL,6500000,4002293,10781688,6731990,4145138,11166495,1,14783981,15311633
2011,tt1541995,Snow Flower and the Secret Fan,none,ok,PASS,6000000,1348205,11348205,6214145,1396324,11753231,1,12696410,13149555
2011,tt1596346,Soul Surfer,none,ok,PASS,18000000,43853424,47158652,18642434,45418587,48841781,1,91012076,94260368
2011,tt0945513,Source Code,disagree,notalk,FAIL,32000000,54712227,140428499,33142105,56664949,145440503,1,195140726,202105452
2011,tt0999913,Straw Dogs,none,ok,PASS,25000000,10324441,11253821,25892270,10692928,11655479,1,21578262,22348407
2011,tt0978764,Sucker Punch,disagree,ok,PASS,75000000,36392502,89758389,77676809,37691379,92961937,1,126150891,130653316
2011,tt1650062,Super 8,disagree,ok,PASS,50000000,127004179,260095987,51784539,131537058,269379017,1,387100166,400916075
2011,tt1675192,Take Shelter,none,ok,PASS,4750000,1728953,3128953,4919531,1790661,3240628,1,4857906,5031289
2011,tt1385826,The Adjustment Bureau,disagree,dubious,FAIL,50200000,62495645,127793502,51991677,64726164,132354553,1,190289147,197080717
2011,tt0983193,The Adventures of Tintin,none,notalk,FAIL,130000000,77591831,373993951,134639802,80361144,387342089,1,451585782,467703233
2011,tt1655442,The Artist,disagree,notalk,FAIL,16000000,44667095,128256712,16571053,46261299,132834295,1,172923807,179095594
2011,tt1412386,The Best Exotic Marigold Hotel,none,ok,PASS,10000000,46383639,134729347,10356908,48039108,139537943,1,181112986,187577051
2011,tt1259521,The Cabin in the Woods,disagree,dubious,FAIL,30000000,42073277,70768144,31070724,43574905,73293915,1,112841421,116868820
2011,tt1093357,The Darkest Hour,none,ok,PASS,34800000,21443494,62831715,36042039,22208829,65074228,1,84275209,87283057
2011,tt1535616,The Divide,none,ok,PASS,3000000,18000,18000,3107072,18642,18642,1,36000,37284
2011,tt1235170,The Future,none,ok,PASS,1000000,568662,568662,1035691,588958,588958,1,1137324,1177916
2011,tt1568346,The Girl with the Dragon Tattoo,disagree,notalk,FAIL,90000000,102515793,233170238,93212171,106174662,241492267,1,335686031,347666929
2011,tt0990407,The Green Hornet,none,notalk,FAIL,110000000,98780042,227983150,113925987,102305579,236120048,1,326763192,338425627
2011,tt1540133,The Guard,none,notalk,FAIL,6000000,5359774,15944629,6214145,5551069,16513705,1,21304403,22064774
2011,tt1454029,The Help,none,ok,PASS,25000000,169705587,213120004,25892270,175762513,220726425,1,382825591,396488938
2011,tt1007029,The Iron Lady,none,ok,PASS,14000000,29959436,115592104,14499671,31028712,119717677,1,145551540,150746389
2011,tt1189340,The Lincoln Lawyer,none,notalk,FAIL,40000000,58009200,87145086,41427631,60079594,90255363,1,145154286,150334957
2011,tt0472399,The Mechanic,none,nowomen,FAIL,42500000,29121498,76347393,44016858,30160867,79072292,1,105468891,109233159
2011,tt1204342,The Muppets,disagree,notalk,FAIL,45000000,88625922,160971922,46606085,91789051,166717137,1,249597844,258506188
2011,tt1161864,The Rite,disagree,dubious,FAIL,37000000,33047633,96047633,38320559,34227129,99475649,1,129095266,133702778
2011,tt1265990,The Roommate,none,ok,PASS,16000000,37300107,40497461,16571053,38631377,41942847,1,77797568,80574224
2011,tt0472181,The Smurfs,none,ok,PASS,110000000,142614158,563066551,113925987,147704169,583162839,1,705680709,730867008
2011,tt1509767,The Three Musketeers,none,men,FAIL,90000000,20377913,139877913,93212171,21105217,144870266,1,160255826,165975483
2011,tt0478304,The Tree of Life,disagree,nowomen,FAIL,35000000,13305665,62305665,36249178,13780555,64529403,1,75611330,78309958
2011,tt1324999,The Twilight Saga: Breaking Dawn - Part 1,none,ok,PASS,127500000,281287133,709938657,132050575,291326492,735276926,1,991225790,1026603418
2011,tt0800369,Thor,disagree,ok,PASS,150000000,181030624,449326618,155353618,187491749,465363438,1,630357242,652855187
2011,tt1340800,Tinker Tailor Soldier Spy,none,notalk,FAIL,21000000,24149393,81452811,21749507,25011304,84359926,1,105602204,109371230
2011,tt0471042,Tower Heist,none,notalk,FAIL,85000000,78046570,153470352,88033717,80832113,158947830,1,231516922,239779943
2011,tt1399103,Transformers: Dark of the Moon,disagree,ok,PASS,195000000,352390543,1123794076,201959703,364967639,1163903170,1,1476184619,1528870809
2011,tt1568911,War Horse,disagree,notalk,FAIL,70000000,79883359,156815529,72498355,82734459,162412399,1,236698888,245146858
2011,tt1291584,Warrior,none,notalk,FAIL,25000000,13657115,24215385,25892270,14144548,25079651,1,37872500,39224199
2011,tt1389137,We Bought a Zoo,disagree,men,FAIL,50000000,75624550,118924550,51784539,78323650,123169061,1,194549100,201492711
2011,tt1714210,Weekend,none,notalk,FAIL,190000,484592,1577585,196781,501887,1633890,1,2062177,2135777
2011,tt0770703,What's Your Number,none,ok,PASS,20000000,14011084,30711084,20713816,14511151,31807187,1,44722168,46318338
2011,tt1449283,Winnie the Pooh,none,nowomen,FAIL,30000000,26692846,50145607,31070724,27645535,51935343,1,76838453,79580878
2011,tt1270798,X-Men: First Class,disagree,ok,PASS,160000000,146408305,355408305,165710526,151633733,368093107,1,501816610,519726840
2011,tt1625346,Young Adult,none,ok,PASS,12000000,16311571,22750356,12428289,16893744,23562334,1,39061927,40456078
2011,tt1742336,Your Sister's Sister,none,ok,PASS,120000,1597486,3090593,124283,1654502,3200899,1,4688079,4855401
2010,tt1542344,127 Hours,disagree,dubious,FAIL,18000000,18335230,60735230,19228173,19586277,64879307,1,79070460,84465584
2010,tt1014759,Alice in Wonderland,none,ok,PASS,200000000,334191110,1024391110,213646368,356993585,1094287202,1,1358582220,1451280787
2010,tt1313092,Animal Kingdom,none,notalk,FAIL,4200000,1044039,8078683,4486574,1115276,8629906,1,9122722,9745182
2010,tt1431181,Another Year,none,ok,PASS,8000000,3205706,18505706,8545855,3424437,19768384,1,21711412,23192821
2010,tt1423894,Barney's Version,none,ok,PASS,30000000,7502560,8845575,32046955,8014473,9449125,1,16348135,17463598
2010,tt1532503,Beginners,none,notalk,FAIL,3200000,5790894,11564267,3418342,6186017,12353318,1,17355161,18539335
2010,tt1164999,Biutiful,none,notalk,FAIL,35000000,5101237,25101237,37388114,5449304,26813941,1,30202474,32263245
2010,tt0947798,Black Swan,disagree,ok,PASS,13000000,106954678,331266710,13887014,114252393,353869648,1,438221388,468122041
2010,tt1120985,Blue Valentine,disagree,men,FAIL,1000000,9737892,16566240,1068232,10402326,17696585,1,26304132,28098911
2010,tt1126591,Burlesque,none,ok,PASS,55000000,39440655,89657398,58752751,42131764,95774887,1,129098053,137906651
2010,tt1194417,Casino Jack,disagree,notalk,FAIL,12500000,2039869,2080869,13352898,2179053,2222851,1,4120738,4401904
2010,tt1020558,Centurion,none,notalk,FAIL,15000000,123570,6623570,16023478,132001,7075508,1,6747140,7207509
2010,tt1438254,Charlie St. Cloud,disagree,notalk,FAIL,44000000,31206263,48478084,47002201,33335524,51785833,1,79684347,85121357
2010,tt0800320,Clash of the Titans,none,dubious,FAIL,125000000,163214888,493214888,133528980,174351340,526867848,1,656429776,701219188
2010,tt1244754,Conviction,none,ok,PASS,12500000,6797696,10133552,13352898,7261515,10824983,1,16931248,18086498
2010,tt1385867,Cop Out,none,notalk,FAIL,37000000,44875481,55909910,39524578,47937418,59724746,1,100785391,107662164
2010,tt1555064,Country Strong,none,ok,PASS,15000000,20218921,20551476,16023478,21598495,21953741,1,40770397,43552236
2010,tt1336617,Cyrus,none,notalk,FAIL,7000000,7468936,10039886,7477623,7978555,10724926,1,17508822,18703481
2010,tt1279935,Date Night,none,ok,PASS,55000000,98711404,152269033,58752751,105446665,162658630,1,250980437,268105295
2010,tt0989757,Dear John,none,nowomen,FAIL,25000000,80014842,111362410,26705796,85474402,118960872,1,191377252,204435274
2010,tt1323594,Despicable Me,disagree,ok,PASS,69000000,251513985,543495033,73707997,268675247,580578700,1,795009018,849253947
2010,tt1314655,Devil,disagree,ok,PASS,10000000,33679655,63354114,10682318,35977680,67676882,1,97033769,103654562
2010,tt1196141,Diary of a Wimpy Kid,none,ok,PASS,15000000,64003625,76954311,16023478,68370710,82205045,1,140957936,150575755
2010,tt0427152,Dinner for Schmucks,none,notalk,FAIL,69000000,73026337,86796502,73707997,78009058,92718787,1,159822839,170727845
2010,tt1270761,Don't Be Afraid of the Dark,none,ok,PASS,25000000,24046682,31551048,26705796,25687431,33703834,1,55597730,59391265
2010,tt1231583,Due Date,none,notalk,FAIL,65000000,100539043,211739043,69435070,107399007,226186388,1,312278086,333585395
2010,tt1013860,Dylan Dog: Dead of Night,none,nowomen,FAIL,20000000,1186538,6090697,21364637,1267498,6506276,1,7277235,7773774
2010,tt1282140,Easy A,disagree,ok,PASS,8000000,58401464,76200721,8545855,62386303,81400037,1,134602185,143786340
2010,tt0879870,"Eat, Pray, Love",disagree,ok,PASS,60000000,80574010,205846861,64093910,86071723,219892171,1,286420871,305963894
2010,tt1226273,Edge of Darkness,none,notalk,FAIL,60000000,43313890,81208697,64093910,46269276,86749716,1,124522587,133018992
2010,tt1531663,Everything Must Go,none,notalk,FAIL,5000000,2712131,2712131,5341159,2897185,2897185,1,5424262,5794370
2010,tt0977855,Fair Game,none,ok,PASS,50000000,11497497,26097497,53411592,12281992,27878177,1,37594994,40160169
2010,tt1433108,Faster,none,nowomen,FAIL,12000000,23240020,35658648,12818782,24825729,38091703,1,58898668,62917432
2010,tt1405500,For Colored Girls,none,ok,PASS,21000000,37729698,38017873,22432869,40304065,40611902,1,75747571,80915967
2010,tt1323045,Frozen,none,notalk,FAIL,150000000,393050114,1004550114,160234776,419868647,1073092418,1,1397600228,1492961065
2010,tt1226229,Get Him To The Greek,none,notalk,FAIL,40000000,61153526,91455875,42729274,65326144,97696078,1,152609401,163022222
2010,tt1322312,Going the Distance,none,ok,PASS,32000000,17804299,39990165,34183419,19019119,42718768,1,57794464,61737887
2010,tt0947810,Green Zone,disagree,nowomen,FAIL,100000000,35497337,97523020,106823184,37919386,104177195,1,133020357,142096581
2010,tt1375670,Grown Ups,disagree,ok,PASS,75000000,162001186,272223430,80117388,173054825,290797736,1,434224616,463852561
2010,tt1376195,Gunless,none,men,FAIL,9900000,458054,458054,10575495,489308,489308,1,916108,978616
2010,tt0926084,Harry Potter and the Deathly Hallows: Part 1,disagree,ok,PASS,125000000,295983305,956399711,133528980,316178791,1021656625,1,1252383016,1337835416
2010,tt1231587,Hot Tub Time Machine,none,notalk,FAIL,36000000,50269859,63209958,38456346,53699864,67522890,1,113479817,121222754
2010,tt0892769,How to Train Your Dragon,none,ok,PASS,165000000,217581231,494870991,176258254,232427199,528636950,1,712452222,761064149
2010,tt1226236,I Am Love,none,ok,PASS,10000000,5005465,15132211,10682318,5346997,16164710,1,20137676,21511707
2010,tt1375666,Inception,disagree,dubious,FAIL,160000000,292576195,832584416,170917095,312539208,889393184,1,1125160611,1201932392
2010,tt1591095,Insidious,disagree,ok,PASS,1500000,54009150,99870886,1602348,57694294,106685260,1,153880036,164379554
2010,tt1228705,Iron Man 2,none,ok,PASS,170000000,312433331,623561331,181599413,333751233,666108069,1,935994662,999859302
2010,tt0804497,It's Kind of a Funny Story,none,notalk,FAIL,8000000,6363628,6628326,8545855,6797830,7080589,1,12991954,13878419
2010,tt1250777,Kick-Ass,disagree,notalk,FAIL,28000000,48071303,97527535,29910492,51351297,104182018,1,145598838,155533315
2010,tt1013743,Knight and Day,disagree,men,FAIL,117000000,76423035,262142047,124983125,81637519,280028482,1,338565082,361666001
2010,tt1038686,Legion,none,ok,PASS,26000000,40168080,68854097,27774028,42908822,73552139,1,109022177,116460961
2010,tt1228987,Let Me In,disagree,notalk,FAIL,20000000,12134935,28270399,21364637,12962924,30199340,1,40405334,43162264
2010,tt0892318,Letters to Juliet,disagree,dubious,FAIL,30000000,53032453,79135982,32046955,56650955,84535576,1,132168435,141186531
2010,tt0758752,Love and Other Drugs,disagree,men,FAIL,30000000,32367005,102719647,32046955,34575465,109728398,1,135086652,144303863
2010,tt0985694,Machete,none,ok,PASS,12500000,26593646,44331957,13352898,28408179,47356808,1,70925603,75764987
2010,tt1371155,Made In Dagenham,none,ok,PASS,8000000,1095369,15644196,8545855,1170108,16711628,1,16739565,17881736
2010,tt1518812,Meek's Cutoff,none,men,FAIL,2000000,977772,1869928,2136464,1044487,1997517,1,2847700,3042004
2010,tt1001526,Megamind,disagree,nowomen,FAIL,130000000,148415853,321887208,138870139,158542540,343850165,1,470303061,502392705
2010,tt1470827,Monsters,disagree,nowomen,FAIL,500000,237301,5639730,534116,253492,6024539,1,5877031,6278031
2010,tt1126618,Morning Glory,none,ok,PASS,40000000,31011732,60040974,42729274,33127720,64137680,1,91052706,97265400
2010,tt1415283,Nanny McPhee and the Big Bang,none,ok,PASS,35000000,29197642,97799865,37388114,31189851,104472930,1,126997507,135662781
2010,tt1334260,Never Let Me Go,none,ok,PASS,15000000,2434652,11509512,16023478,2600773,12294827,1,13944164,14895600
2010,tt1536044,Paranormal Activity 2,none,ok,PASS,3000000,84752907,177512032,3204696,90535754,189624005,1,262264939,280159759
2010,tt0814255,Percy Jackson & the Olympians: The Lightning Thief,disagree,dubious,FAIL,95000000,88768303,226467130,101482025,94825128,241919399,1,315235433,336744527
2010,tt0878835,Please Give,none,ok,PASS,3000000,4033574,4570178,3204696,4308792,4882010,1,8603752,9190802
2010,tt1424381,Predators,none,nowomen,FAIL,40000000,52000688,127234389,42729274,55548791,135915826,1,179235077,191464617
2010,tt0473075,Prince of Persia: The Sands of Time,none,nowomen,FAIL,200000000,90759676,335059676,213646368,96952376,357921415,1,425819352,454873791
2010,tt0935075,Rabbit Hole,none,ok,PASS,5000000,2229058,5839592,5341159,2381151,6238038,1,8068650,8619189
2010,tt0493949,Ramona and Beezus,none,ok,PASS,15000000,26167002,27469621,16023478,27952425,29343924,1,53636623,57296349
2010,tt1245526,Red,disagree,men,FAIL,60000000,90380162,196439693,64093910,96546967,209843135,1,286819855,306390102
2010,tt1403981,Remember Me,none,ok,PASS,16000000,19068240,56506120,17091709,20369301,60361637,1,75574360,80730938
2010,tt1053424,Repo Men,none,ok,PASS,32000000,13942007,18195238,34183419,14893296,19436733,1,32137245,34330029
2010,tt0955308,Robin Hood,disagree,dubious,FAIL,210000000,105487148,322459006,224328687,112684730,344460978,1,427946154,457145708
2010,tt0944835,Salt,disagree,ok,PASS,130000000,118311368,295713467,138870139,126383971,315890541,1,414024835,442274512
2010,tt0446029,Scott Pilgrim vs. the World,none,ok,PASS,85000000,31611316,48089760,90799707,33768214,51371013,1,79701076,85139227
2010,tt1028576,Secretariat,none,ok,PASS,35000000,59699513,60376247,37388114,63772921,64495830,1,120075760,128268751
2010,tt1261945,Sex and the city 2,none,ok,PASS,95000000,95347692,294680778,101482025,101853441,314787390,1,390028470,416640831
2010,tt0892791,Shrek Forever After,none,notalk,FAIL,165000000,238736787,756244673,176258254,255026238,807844640,1,994981460,1062870878
2010,tt1130884,Shutter Island,none,notalk,FAIL,80000000,128012934,296831073,85458547,136747492,317084404,1,424844007,453831896
2010,tt1564585,Skyline,none,dubious,FAIL,10000000,21416355,78693371,10682318,22877632,84062765,1,100109726,106940397
2010,tt1421051,Somewhere,disagree,dubious,FAIL,7000000,1785645,14385645,7477623,1907483,15367204,1,16171290,17274687
2010,tt1440292,Submarine,none,notalk,FAIL,1900000,467602,4581937,2029641,499507,4894571,1,5049539,5394078
2010,tt1512235,Super,none,notalk,FAIL,2500000,327716,518362,2670580,350077,553731,1,846078,903808
2010,tt1135084,Takers,none,notalk,FAIL,32000000,57744720,70587268,34183419,61684749,75403567,1,128331988,137088316
2010,tt0398286,Tangled,none,ok,PASS,260000000,200821936,586581936,277740279,214524387,626605502,1,787403872,841129889
2010,tt0429493,The A-Team,disagree,nowomen,FAIL,110000000,77222099,177241171,117505503,82491105,189334662,1,254463270,271825767
2010,tt1212436,The Back-up Plan,none,ok,PASS,35000000,37490007,75281179,37388114,40048019,80417752,1,112771186,120465771
2010,tt0980970,The Chronicles of Narnia: The Voyage of the Dawn Treader,disagree,ok,PASS,155000000,104386950,418186950,165575935,111509464,446720616,1,522573900,558230080
2010,tt0968264,The Conspirator,none,dubious,FAIL,25000000,11538204,15907411,26705796,12325477,16992803,1,27445615,29318280
2010,tt0455407,The Crazies,none,ok,PASS,19000000,39123589,54956140,20296405,41793064,58705899,1,94079729,100498963
2010,tt1226753,The Debt,none,ok,PASS,20000000,31177548,46604054,21364637,33304850,49783934,1,77781602,83088784
2010,tt1320253,The Expendables,none,notalk,FAIL,82000000,103068524,268268174,87595011,110101079,286572606,1,371336698,396673685
2010,tt0964517,The Fighter,none,men,FAIL,11000000,93617009,129262388,11750550,100004670,138082199,1,222879397,238086869
2010,tt1139328,The Ghost Writer,none,men,FAIL,45000000,15541549,65532491,48070433,16601978,70003894,1,81074040,86605872
2010,tt0775489,The Illusionist,none,nowomen,FAIL,16500000,39868642,83792062,17625825,42588953,89509349,1,123660704,132098302
2010,tt1155076,The Karate Kid,disagree,dubious,FAIL,40000000,176591618,359091618,42729274,188640789,383593100,1,535683236,572233889
2010,tt0842926,The Kids Are All Right,none,ok,PASS,4000000,20811365,36275469,4272927,22231363,38750611,1,57086834,60981974
2010,tt0954947,The Killer Inside Me,none,notalk,FAIL,13000000,217277,3617277,13887014,232102,3864090,1,3834554,4096192
2010,tt1504320,The King's Speech,disagree,ok,PASS,15000000,138797449,430821166,16023478,148267855,460216888,1,569618615,608484743
2010,tt0938283,The Last Airbender,disagree,notalk,FAIL,150000000,131772187,319713881,160234776,140763246,341528548,1,451486068,482291794
2010,tt1320244,The Last Exorcism,none,ok,PASS,1800000,41034350,70165900,1922817,43834199,74953449,1,111200250,118787648
2010,tt0480255,The Losers,none,notalk,FAIL,25000000,23591432,26714018,26705796,25201119,28536765,1,50305450,53737884
2010,tt1458175,The Next Three Days,none,ok,PASS,30000000,21148651,67255916,32046955,22591662,71844911,1,88404567,94436573
2010,tt1386588,The Other Guys,disagree,nowomen,FAIL,100000000,119219978,170936470,106823184,127354577,182599780,1,290156448,309954357
2010,tt1017451,The Runaways,none,ok,PASS,9500000,3573673,5278632,10148202,3817511,5638803,1,8852305,9456314
2010,tt1285016,The Social Network,disagree,notalk,FAIL,40000000,96962694,224922135,42729274,103578637,240268986,1,321884829,343847623
2010,tt0963966,The Sorcerer's Apprentice,none,notalk,FAIL,160000000,63150991,215150991,170917095,67459899,229831139,1,278301982,297291038
2010,tt1273678,The Spy Next Door,none,ok,PASS,28000000,24307106,50983364,29910492,25965625,54462053,1,75290470,80427678
2010,tt0889573,The Switch,none,men,FAIL,19000000,27758465,49858465,20296405,29652476,53260400,1,77616930,82912876
2010,tt1274300,The Tempest,none,ok,PASS,20000000,277943,277943,21364637,296908,296908,1,555886,593816
2010,tt1243957,The Tourist,none,nowomen,FAIL,100000000,67631157,278731369,106823184,72245755,297749724,1,346362526,369995479
2010,tt0840361,The Town,none,notalk,FAIL,37000000,92186262,152566881,39524578,98476300,162976800,1,244753143,261453100
2010,tt1325004,The Twilight Saga: Eclipse,disagree,ok,PASS,68000000,300531751,699590681,72639765,321037586,747325041,1,1000122432,1068362627
2010,tt0780653,The Wolfman,disagree,notalk,FAIL,150000000,62189884,142634358,160234776,66433214,152366563,1,204824242,218799777
2010,tt1570989,Tiny Furniture,none,ok,PASS,50000,391674,424149,53412,418399,453089,1,815823,871488
2010,tt0435761,Toy Story 3,disagree,dubious,FAIL,200000000,415004880,1063759456,213646368,443321427,1136341723,1,1478764336,1579663150
2010,tt1104001,Tron Legacy,disagree,notalk,FAIL,200000000,172062763,397562763,213646368,183802922,424689202,1,569625526,608492124
2010,tt1403865,True Grit,disagree,ok,PASS,35000000,171243005,252276928,37388114,182927231,269490247,1,423519933,452417478
2010,tt1465522,Tucker and Dale vs Evil,none,ok,PASS,5000000,223838,5476793,5341159,239111,5850485,1,5700631,6089596
2010,tt0477080,Unstoppable,none,dubious,FAIL,95000000,81562942,169511609,101482025,87128132,181077698,1,251074551,268205830
2010,tt0817230,Valentine's Day,none,ok,PASS,52000000,110485654,217569328,55548056,118024294,232414484,1,328054982,350438778
2010,tt1027718,Wall Street: Money Never Sleeps,disagree,dubious,FAIL,70000000,52474616,137431619,74776229,56055056,146808831,1,189906235,202863887
2010,tt1183923,Welcome to the Rileys,none,ok,PASS,10000000,152857,312857,10682318,163287,334204,1,465714,497491
2010,tt1235189,Wild Target,none,notalk,FAIL,8000000,109338,109338,8545855,116798,116798,1,218676,233596
2010,tt1399683,Winter's Bone,disagree,ok,PASS,2000000,6531503,16131552,2136464,6977159,17232238,1,22663055,24209397
2010,tt1216520,Womb,none,ok,PASS,13000000,,,13887014,,,1,,
2010,tt1302067,Yogi Bear,none,nowomen,FAIL,80000000,100246011,202284317,85458547,107085981,216086548,1,302530328,323172529
2010,tt1414382,You Again,none,ok,PASS,20000000,25702053,32838945,21364637,27455751,35079607,1,58540998,62535358
2010,tt1182350,You Will Meet a Tall Dark Stranger,none,ok,PASS,15000000,3247816,34247816,16023478,3469420,36584608,1,37495632,40054028
2009,tt1022603,(500) Days of Summer,disagree,notalk,FAIL,7500000,32391374,60803210,8142987,35168338,66015966,2,93194584,101184304
2009,tt0974661,17 Again,disagree,ok,PASS,40000000,64167069,139474906,43429264,69668214,151432312,2,203641975,221100526
2009,tt1190080,2012,disagree,notalk,FAIL,200000000,166112167,788408539,217146319,180353228,856000062,2,954520706,1036353290
2009,tt0472033,9,none,nowomen,FAIL,30000000,31749894,48559999,32571948,34471863,52723125,2,80309893,87194988
2009,tt0971209,A Perfect Getaway,disagree,dubious,FAIL,14000000,15515460,22815460,15200242,16845625,24771466,2,38330920,41617091
2009,tt1019452,A Serious Man,none,men,FAIL,7000000,9228788,30360570,7600121,10019987,32963430,2,39589358,42983417
2009,tt1315981,A Single Man,none,notalk,FAIL,7000000,9176000,28142379,7600121,9962673,30555070,2,37318379,40517743
2009,tt1185836,Adam,none,men,FAIL,3200000,2277396,2828590,3474341,2472641,3071090,2,5105986,5543731
2009,tt1091722,Adventureland,disagree,men,FAIL,9800000,16044025,17144025,10640170,17419505,18613810,2,33188050,36033315
2009,tt1186830,Agora,none,notalk,FAIL,70000000,619423,38992292,76001212,672527,42335163,2,39611715,43007690
2009,tt1077262,Ajami,disagree,men,FAIL,1000000,621859,621859,1085732,675172,675172,2,1243718,1350344
2009,tt0881891,All About Steve,none,ok,PASS,15000000,33862903,40127259,16285974,36766024,43567433,2,73990162,80333457
2009,tt1174732,An Education,none,ok,PASS,7500000,12574914,29652736,8142987,13652981,32194912,2,42227650,45847893
2009,tt0808151,Angels & Demons,none,nowomen,FAIL,150000000,133375846,490875846,162859739,144810370,532959416,2,624251692,677769786
2009,tt0913354,Armored,none,nowomen,FAIL,20000000,15988876,23661038,21714632,17359628,25689537,2,39649914,43049165
2009,tt0375568,Astro Boy,none,dubious,FAIL,65000000,19551067,44093014,70572554,21227211,47873178,2,63644081,69100389
2009,tt0499549,Avatar,disagree,men,FAIL,425000000,760507625,2783918982,461435929,825707158,3022588801,2,3544426607,3848295959
2009,tt1176740,Away We Go,none,ok,PASS,21000000,9451946,10108016,22800364,10262276,10974592,2,19559962,21236868
2009,tt0889583,Br&uuml;no,disagree,nowomen,FAIL,42000000,60054530,130788243,45600727,65203101,142000928,2,190842773,207204029
2009,tt0901476,Bride Wars,none,ok,PASS,30000000,58715510,115150424,32571948,63749284,125022454,2,173865934,188771738
2009,tt0810784,Bright Star,none,ok,PASS,8500000,4444637,17260680,9228719,4825683,18740466,2,21705317,23566149
2009,tt1210042,Brooklyn's Finest,none,notalk,FAIL,17000000,27163593,39233233,18457437,29492371,42596761,2,66396826,72089132
2009,tt0765010,Brothers,none,ok,PASS,26000000,28544157,45043870,28229022,30991293,48905553,2,73588027,79896846
2009,tt1232207,Capitalism: A Love Story,disagree,notalk,FAIL,20000000,14363397,19121531,21714632,15594794,20760850,2,33484928,36355644
2009,tt0795351,Case 39,none,ok,PASS,27000000,13261851,29302804,29314753,14398811,31814980,2,42564655,46213791
2009,tt1352824,Chloe,disagree,men,FAIL,13000000,3075255,9675172,14114511,3338902,10504640,2,12750427,13843542
2009,tt0844471,Cloudy with a Chance of Meatballs,disagree,notalk,FAIL,100000000,124870275,236827677,108573160,135575603,257131292,2,361697952,392706895
2009,tt1035736,Coco avant Chanel,none,ok,PASS,23000000,6113834,50813834,24971827,6637983,55170185,2,56927668,61808168
2009,tt0327597,Coraline,none,ok,PASS,60000000,75286229,126037057,65143896,81740638,136842415,2,201323286,218583053
2009,tt0433362,Daybreakers,none,notalk,FAIL,20000000,30101577,51401577,21714632,32682233,55808316,2,81503154,88490549
2009,tt1278340,Dead Snow,disagree,men,FAIL,800000,46742,2194020,868585,50749,2382117,2,2240762,2432866
2009,tt1136608,District 9,disagree,notalk,FAIL,30000000,115646235,215196627,32571948,125560771,233645777,2,330842862,359206548
2009,tt1127180,Drag Me to Hell,none,ok,PASS,30000000,42100625,91388487,32571948,45709979,99223368,2,133489112,144933347
2009,tt1191111,Enter the Void,none,notalk,FAIL,16000000,337997,337997,17371706,366974,366974,2,675994,733948
2009,tt0780511,Everybody's Fine,none,men,FAIL,20000000,9208876,9208876,21714632,9998368,9998368,2,18417752,19996736
2009,tt0432283,Fantastic Mr. Fox,none,notalk,FAIL,40000000,21002919,46498922,43429264,22803533,50485349,2,67501841,73288882
2009,tt1013752,Fast & Furious,none,notalk,FAIL,85000000,155064265,363064265,92287186,168358172,394190344,2,518128530,562548516
2009,tt1083456,Fired Up!,none,notalk,FAIL,20000000,17231291,18608570,21714632,18708557,20203912,2,35839861,38912469
2009,tt1232776,Fish Tank,none,ok,PASS,3000000,374675,5922292,3257195,406796,6430020,2,6296967,6836816
2009,tt0758746,Friday the 13th,none,men,FAIL,17000000,65002019,91700771,18457437,70574746,99562425,2,156702790,170137171
2009,tt1201167,Funny People,none,notalk,FAIL,72500000,51855045,71880305,78715541,56300661,78042718,2,123735350,134343379
2009,tt0436339,G-Force,none,notalk,FAIL,150000000,119436770,287389685,162859739,129676275,312028062,2,406826455,441704337
2009,tt1046173,G.I. Joe: The Rise of Cobra,disagree,notalk,FAIL,175000000,150201498,302469017,190003029,163078512,328400169,2,452670515,491478681
2009,tt1034032,Gamer,none,notalk,FAIL,50000000,20534907,35062683,54286580,22295397,38068663,2,55597590,60364060
2009,tt1194263,Get Low,disagree,notalk,FAIL,7000000,9176933,9696933,7600121,9963686,10528267,2,18873866,20491953
2009,tt1289406,Harry Brown,none,notalk,FAIL,7300000,1818681,6294140,7925841,1974599,6833747,2,8112821,8808346
2009,tt0417741,Harry Potter and the Half-Blood Prince,disagree,ok,PASS,250000000,301959197,934416487,271432899,327846641,1014525504,2,1236375684,1342372145
2009,tt1001508,He's Just Not That Into You,none,ok,PASS,40000000,93953653,178390243,43429264,102008450,193683923,2,272343896,295692373
2009,tt1024744,I Come with the Rain,none,nowomen,FAIL,18000000,0,627422,19543169,,681212,2,627422,
2009,tt1045772,I Love You Phillip Morris,disagree,notalk,FAIL,13000000,2037459,15144685,14114511,2212134,16443063,2,17182144,18655197
2009,tt1155056,"I Love You, Man",disagree,men,FAIL,40000000,71440011,91729503,43429264,77564677,99593620,2,163169514,177158297
2009,tt1080016,Ice Age: Dawn of the Dinosaurs,none,notalk,FAIL,90000000,196573705,886968695,97715844,213426283,963009937,2,1083542400,1176436220
2009,tt0361748,Inglourious Basterds,disagree,dubious,FAIL,70000000,120831050,316971720,76001212,131190089,344146212,2,437802770,475336301
2009,tt1057500,Invictus,none,notalk,FAIL,49000000,37491364,124491364,53200848,40705558,135164207,2,161982728,175869765
2009,tt1230414,It's Complicated,none,ok,PASS,85000000,112735375,224614744,92287186,122400359,243871325,2,337350119,366271684
2009,tt1131734,Jennifer's Body,none,ok,PASS,16000000,16204793,32832166,17371706,17594056,35646920,2,49036959,53240976
2009,tt1135503,Julie & Julia,none,ok,PASS,40000000,94125426,126646119,43429264,102194949,137503693,2,220771545,239698642
2009,tt0448011,Knowing,none,notalk,FAIL,50000000,79957634,187858642,54286580,86812530,203964063,2,267816276,290776593
2009,tt1197624,Law Abiding Citizen,disagree,notalk,FAIL,53000000,73357727,131159781,57543775,79646802,142404318,2,204517508,222051120
2009,tt0808526,Life During Wartime,none,ok,PASS,4500000,281447,281447,4885792,305576,305576,2,562894,611152
2009,tt1149361,Micmacs (Micmacs &agrave; tire-larigot),none,dubious,FAIL,42000000,1259693,11756922,45600727,1367688,12764862,2,13016615,14132550
2009,tt0892782,Monsters vs Aliens,disagree,dubious,FAIL,175000000,198351526,381687380,190003029,215356519,414410048,2,580038906,629766567
2009,tt1182345,Moon,disagree,notalk,FAIL,5000000,5010163,10676073,5428658,5439692,11591350,2,15686236,17031042
2009,tt1121977,Mother and Child,none,ok,PASS,7000000,1110509,5010509,7600121,1205715,5440068,2,6121018,6645783
2009,tt1179891,My Bloody Valentine 3D,none,men,FAIL,14000000,51545952,102754998,15200242,55965069,111564348,2,154300950,167529417
2009,tt1078588,My Sister's Keeper,none,ok,PASS,27500000,49200230,96673002,29857619,53418244,104960933,2,145873232,158379177
2009,tt0875034,Nine,disagree,men,FAIL,80000000,19676965,53508858,86858528,21363903,58096258,2,73185823,79460161
2009,tt1186367,Ninja Assassin,disagree,notalk,FAIL,50000000,38122883,61622883,54286580,41391219,66905911,2,99745766,108297130
2009,tt1266029,Nowhere Boy,none,dubious,FAIL,1900000,1445366,7785229,2062890,1569280,8452669,2,9230595,10021949
2009,tt1235796,Ondine,none,ok,PASS,12000000,550472,550472,13028779,597665,597665,2,1100944,1195330
2009,tt1532957,Paa,none,men,FAIL,4300000,199228,9791282,4668646,216308,10630704,2,9990510,10847012
2009,tt1188729,Pandorum,none,notalk,FAIL,40000000,10330853,17033431,43429264,11216534,18493734,2,27364284,29710268
2009,tt1003034,Perrier's Bounty,none,nowomen,FAIL,6600000,828,828,7165829,899,899,2,1656,1798
2009,tt0762125,Planet 51,none,notalk,FAIL,60000000,42194060,108996113,65143896,45811424,118340524,2,151190173,164151948
2009,tt0929632,Precious: Based on the Novel Push by Sapphire,none,ok,PASS,10000000,47566524,68722848,10857316,51644478,74614567,2,116289372,126259045
2009,tt1152836,Public Enemies,none,notalk,FAIL,102500000,97104620,210379983,111287489,105429554,228416195,2,307484603,333845749
2009,tt0465580,Push,none,ok,PASS,38000000,31811527,44411527,41257801,34538780,48218998,2,76223054,82757778
2009,tt0988045,Sherlock Holmes,none,notalk,FAIL,90000000,209028679,498438212,97715844,226949041,541170116,2,707466891,768119157
2009,tt1017460,Splice,none,ok,PASS,30000000,17010170,22461001,32571948,18468479,24386618,2,39471171,42855097
2009,tt0796366,Star Trek,disagree,ok,PASS,140000000,257730019,385680446,152002424,279825625,418745446,2,643410465,698571071
2009,tt0473705,State of Play,none,ok,PASS,60000000,37017955,91445389,65143896,40191563,99285148,2,128463344,139476711
2009,tt0986263,Surrogates,none,notalk,FAIL,80000000,38577772,119668350,86858528,41885106,129927709,2,158246122,171812815
2009,tt0438488,Terminator Salvation,disagree,men,FAIL,200000000,125322469,371628539,217146319,136066564,403488847,2,496951008,539555411
2009,tt0878804,The Blind Side,none,men,FAIL,35000000,255959475,305705795,38000606,277903289,331914441,2,561665270,609817730
2009,tt1131729,The Boat That Rocked,disagree,nowomen,FAIL,50000000,8017467,37472651,54286580,8704817,40685241,2,45490118,49390058
2009,tt1300851,The Boondock Saints II: All Saints Day,none,nowomen,FAIL,8000000,10273187,10273187,8685853,11153924,11153924,2,20546374,22307848
2009,tt0362478,The Box,none,ok,PASS,25000000,15051977,26341896,27143290,16342407,28600229,2,41393873,44942636
2009,tt0896923,The City of Your Final Destination,disagree,ok,PASS,8300000,493296,1353296,9011572,535587,1469316,2,1846592,2004903
2009,tt1144884,The Final Destination,none,ok,PASS,40000000,66477700,187384627,43429264,72176939,203449410,2,253862327,275626349
2009,tt1220198,The Fourth Kind,none,ok,PASS,10000000,26218170,49486874,10857316,28465896,53729463,2,75705044,82195359
2009,tt1132620,The Girl with the Dragon Tattoo,disagree,dubious,FAIL,90000000,102515793,233170238,97715844,111304636,253160295,2,335686031,364464931
2009,tt1103982,The Girlfriend Experience,none,dubious,FAIL,1300000,695840,1005840,1411451,755495,1092072,2,1701680,1847567
2009,tt1247662,The Good Guy,none,ok,PASS,10000000,100688,100688,10857316,109320,109320,2,201376,218640
2009,tt1119646,The Hangover,none,notalk,FAIL,35000000,277322503,469553471,38000606,301097804,509809040,2,746875974,810906844
2009,tt1054606,The Imaginarium of Doctor Parnassus,none,notalk,FAIL,30000000,7689607,64352607,32571948,8348849,69869659,2,72042214,78218508
2009,tt1130080,The Informant!,none,notalk,FAIL,22000000,33316821,41771168,23886095,36173125,45352277,2,75087989,81525402
2009,tt1058017,The Invention of Lying,none,men,FAIL,18500000,18451251,32679264,20086035,20033106,35480909,2,51130515,55514015
2009,tt0824758,The Last Station,none,ok,PASS,18000000,6617867,15696146,19543169,7185227,17041802,2,22314013,24227029
2009,tt0380510,The Lovely Bones,none,ok,PASS,95000000,44114232,94894448,103144502,47896216,103029901,2,139008680,150926117
2009,tt1234548,The Men Who Stare at Goats,none,nowomen,FAIL,24000000,32428195,67348218,26057558,35208316,73122088,2,99776413,108330404
2009,tt0790712,The Messenger,none,notalk,FAIL,6500000,1109660,1409660,7057255,1204793,1530512,2,2519320,2735305
2009,tt0780521,The Princess and the Frog,none,ok,PASS,105000000,104400899,270997378,114001818,113351355,294230416,2,375398277,407581771
2009,tt1041829,The Proposal,disagree,men,FAIL,40000000,163958031,314709717,43429264,178014415,341690283,2,478667748,519704698
2009,tt0898367,The Road,disagree,notalk,FAIL,25000000,8114270,27614270,27143290,8809919,29981685,2,35728540,38791604
2009,tt0485601,The Secret of Kells,disagree,nowomen,FAIL,8000000,690290,2600916,8685853,749470,2823897,2,3291206,3573367
2009,tt0821642,The Soloist,none,notalk,FAIL,60000000,31720158,38454152,65143896,34439578,41750888,2,70174310,76190466
2009,tt1111422,The Taking of Pelham 123,none,nowomen,FAIL,110000000,65452312,152364370,119430476,71063643,165426811,2,217816682,236490454
2009,tt0452694,The Time Traveler's Wife,none,dubious,FAIL,39000000,63414846,98666635,42343532,68851502,107125483,2,162081481,175976985
2009,tt1142988,The Ugly Truth,none,men,FAIL,38000000,88915214,205230042,41257801,96538057,222824741,2,294145256,319362798
2009,tt1139668,The Unborn,none,ok,PASS,16000000,42670410,78208812,17371706,46328612,84913778,2,120879222,131242390
2009,tt0962736,The Young Victoria,none,ok,PASS,35000000,11001272,31878891,38000606,11944429,34611919,2,42880163,46556348
2009,tt1055369,Transformers: Revenge of the Fallen,disagree,ok,PASS,210000000,402111870,836519699,228003635,436585563,908235868,2,1238631569,1344821431
2009,tt1049413,Up,none,notalk,FAIL,175000000,293004164,731542621,190003029,318123879,794258938,2,1024546785,1112382817
2009,tt1193138,Up in the Air,disagree,men,FAIL,30000000,83823381,166842739,32571948,91009693,181146433,2,250666120,272156126
2009,tt1068678,Veronika Decides to Die,none,ok,PASS,9000000,,,9771584,,,2,,
2009,tt0409459,Watchmen,disagree,men,FAIL,138000000,107509799,184068357,149830960,116726786,199848831,2,291578156,316575617
2009,tt1178663,Whatever Works,disagree,dubious,FAIL,15000000,5306706,35106706,16285974,5761658,38116460,2,40413412,43878118
2009,tt0386117,Where the Wild Things Are,none,notalk,FAIL,100000000,77233467,99123656,108573160,83854815,107621685,2,176357123,191476500
2009,tt1172233,Whip It,none,ok,PASS,15000000,13043363,18856151,16285974,14161591,20472719,2,31899514,34634310
2009,tt0365929,Whiteout,none,ok,PASS,35000000,10275638,12254746,38000606,11156585,13305365,2,22530384,24461950
2009,tt0458525,X-Men Origins: Wolverine,disagree,dubious,FAIL,150000000,179883157,374825760,162859739,195304827,406960171,2,554708917,602264998
2009,tt0448182,Yesterday Was a Lie,none,ok,PASS,200000,,,217146,,,2,,
2009,tt0403702,Youth in Revolt,disagree,notalk,FAIL,18000000,15285588,19685588,19543169,16596046,21373265,2,34971176,37969311
2009,tt1156398,Zombieland,disagree,ok,PASS,23600000,75590286,102236596,25623266,82070762,111001503,2,177826882,193072265
2008,tt0478087,21,none,ok,PASS,35000000,81159365,157852532,37878971,87835235,170836899,2,239011897,258672134
2008,tt0800308,Appaloosa,none,notalk,FAIL,20000000,20211394,27735474,21645126,21873909,30016892,2,47946868,51890801
2008,tt0455824,Australia,none,men,FAIL,130000000,49554002,215080810,140693320,53630131,232772564,2,264634812,286402695
2008,tt0871426,Baby Mama,none,ok,PASS,30000000,60494212,64391484,32467689,65470243,69688090,2,124885696,135158333
2008,tt0799934,Be Kind Rewind,none,notalk,FAIL,20000000,11175164,30894247,21645126,12094392,33435494,2,42069411,45529886
2008,tt0960731,Bedtime Stories,none,ok,PASS,80000000,110101975,218357961,86580505,119158557,236319281,2,328459936,355477838
2008,tt0861689,Blindness,none,ok,PASS,25000000,3073392,20052958,27056408,3326198,21702440,2,23126350,25028638
2008,tt0397892,Bolt,disagree,ok,PASS,150000000,114053759,313953759,162338447,123435400,339778437,2,428007518,463213837
2008,tt0887883,Burn After Reading,none,notalk,FAIL,37000000,60355347,163415735,40043484,65319955,176857711,2,223771082,242177666
2008,tt0824747,Changeling,none,ok,PASS,55000000,35739802,113805580,59524097,38679626,123166807,2,149545382,161846433
2008,tt0892255,Che: Part One,none,notalk,FAIL,58000000,293708,30118557,62770866,317867,32595998,2,30412265,32913865
2008,tt0970411,City of Ember,none,ok,PASS,38000000,7871693,11817059,41125740,8519189,12789087,2,19688752,21308276
2008,tt1060277,Cloverfield,none,ok,PASS,25000000,80048433,170764033,27056408,86632922,184810452,2,250812466,271443374
2008,tt0489018,Day of the Dead,none,ok,PASS,18000000,,,19480614,,,2,,
2008,tt0452608,Death Race,none,notalk,FAIL,65000000,36316032,72516819,70346660,39303255,78481785,2,108832851,117785040
2008,tt1034303,Defiance,none,ok,PASS,50000000,28644813,42268745,54112816,31001030,45745616,2,70913558,76746646
2008,tt0832266,"Definitely, Maybe",none,ok,PASS,7000000,32241649,55863786,7575794,34893728,60458935,2,88105435,95352663
2008,tt0483607,Doomsday,none,ok,PASS,33000000,11008770,21621188,35714458,11914311,23399667,2,32629958,35313978
2008,tt0918927,Doubt,none,ok,PASS,20000000,33446470,50946957,21645126,36197653,55137666,2,84393427,91335319
2008,tt1059786,Eagle Eye,disagree,notalk,FAIL,80000000,101440743,178066569,86580505,109784884,192713668,2,279507312,302498552
2008,tt0808244,Easy Virtue,none,ok,PASS,14000000,2656784,12656784,15151588,2875321,13697884,2,15313568,16573205
2008,tt1129423,Fireproof,none,men,FAIL,500000,33456317,33473297,541128,36208310,36226687,2,66929614,72434997
2008,tt0486321,Fly Me to the Moon,none,nowomen,FAIL,25000000,14543943,57546746,27056408,15740274,62280329,2,72090689,78020603
2008,tt0800039,Forgetting Sarah Marshall,none,ok,PASS,30000000,63172463,105173042,32467689,68368797,113824188,2,168345505,182192985
2008,tt0369436,Four Christmases,none,ok,PASS,80000000,120146040,163546040,86580505,130028810,176998734,2,283692080,307027544
2008,tt0870111,Frost/Nixon,none,notalk,FAIL,29000000,18622031,28144586,31385433,20153811,30459656,2,46766617,50613467
2008,tt0978759,Frozen River,none,ok,PASS,1000000,2511476,6030129,1082256,2718061,6526145,2,8541605,9244206
2008,tt0876563,Gake no ue no Ponyo,none,ok,PASS,34000000,15090399,205312666,36796715,16331680,222200929,2,220403065,238532609
2008,tt0995039,Ghost Town,none,notalk,FAIL,20000000,13252641,26612350,21645126,14342754,28801384,2,39864991,43144138
2008,tt1205489,Gran Torino,disagree,men,FAIL,25000000,148095302,274543085,27056408,160277075,297125986,2,422638387,457403061
2008,tt1104733,Hamlet 2,none,ok,PASS,9000000,4886216,4898285,9740307,5288138,5301200,2,9784501,10589338
2008,tt0448157,Hancock,none,nowomen,FAIL,150000000,227946274,624346274,162338447,246696294,675702695,2,852292548,922398989
2008,tt1227929,Herb & Dorothy,none,ok,PASS,82500000,75986503,160388063,89286146,82236872,173580993,2,236374566,255817865
2008,tt0962726,High School Musical 3: Senior Year,none,ok,PASS,11000000,90559416,274392880,11904819,98008500,296963426,2,364952296,394971926
2008,tt0465502,Igor,none,men,FAIL,30000000,19528602,31013349,32467689,21134953,33564393,2,50541951,54699346
2008,tt0780536,In Bruges,none,notalk,FAIL,15000000,7800825,34533783,16233845,8442492,37374405,2,42334608,45816897
2008,tt0367882,Indiana Jones and the Kingdom of the Crystal Skull,none,notalk,FAIL,185000000,317023851,786558145,200217418,343101064,851257517,2,1103581996,1194358581
2008,tt0494238,Inkheart,none,ok,PASS,60000000,17303424,58051454,64935379,18726740,62826552,2,75354878,81553292
2008,tt0371746,Iron Man,disagree,men,FAIL,186000000,318604126,582443126,201299674,344811326,630352749,2,901047252,975164075
2008,tt0373051,Journey to the Center of the Earth,none,notalk,FAIL,45000000,101704370,240904370,48701534,110070196,260720275,2,342608740,370790471
2008,tt0489099,Jumper,none,notalk,FAIL,82500000,81168265,223113205,89286146,87844867,241465674,2,304281470,329310541
2008,tt0441773,Kung Fu Panda,disagree,notalk,FAIL,130000000,215434591,631910531,140693320,233155446,683889160,2,847345122,917044606
2008,tt1139797,L&aring;t den r&auml;tte komma in (Let the Right One In),disagree,notalk,FAIL,4500000,2122085,12247682,4870153,2296640,13255131,2,14369767,15551771
2008,tt0866439,Made of Honor,none,men,FAIL,40000000,46012734,106548738,43290252,49797572,115313044,2,152561472,165110616
2008,tt0467197,Max Payne,none,ok,PASS,35000000,40687294,85761789,37878971,44034081,92816237,2,126449083,136850318
2008,tt0765476,Meet Dave,none,notalk,FAIL,60000000,11803254,50648806,64935379,12774146,54814990,2,62452060,67589136
2008,tt1013753,Milk,disagree,notalk,FAIL,20000000,31841299,57293371,21645126,34460447,62006112,2,89134670,96466559
2008,tt1046997,Miracle at St. Anna,none,men,FAIL,45000000,7916887,9110458,48701534,8568101,9859851,2,17027345,18427952
2008,tt0981227,Nick and Norah's Infinite Playlist,none,ok,PASS,10000000,31487293,33544594,10822563,34077322,36303849,2,65031887,70381171
2008,tt0410377,Nim's Island,none,ok,PASS,37000000,48006762,94081683,40043484,51955621,101820495,2,142088445,153776116
2008,tt0910936,Pineapple Express,none,men,FAIL,26000000,87341380,101549277,28138664,94525760,109902346,2,188890657,204428106
2008,tt1226681,Pontypool,disagree,nowomen,FAIL,1500000,3865,31916,1623384,4183,34541,2,35781,38724
2008,tt0368563,Possession,none,ok,PASS,25000000,10103647,14805812,27056408,10934736,16023683,2,24909459,26958419
2008,tt0926129,Prom Night,none,ok,PASS,18000000,43869350,57109687,19480614,47477881,61807319,2,100979037,109285200
2008,tt0830515,Quantum of Solace,none,notalk,FAIL,230000000,169368427,591692078,248918952,183300049,640362486,2,761060505,823662535
2008,tt1082868,Quarantine,none,ok,PASS,12000000,31691811,41291811,12987076,34298662,44688323,2,72983622,78986985
2008,tt1084950,Rachel Getting Married,none,ok,PASS,12000000,12796861,13326864,12987076,13849484,14423083,2,26123725,28272567
2008,tt0959337,Revolutionary Road,none,ok,PASS,45000000,22911480,79564960,48701534,24796094,86109680,2,102476440,110905774
2008,tt1032755,RocknRolla,none,notalk,FAIL,18000000,5700626,27794339,19480614,6169538,30080599,2,33494965,36250137
2008,tt0814314,Seven Pounds,none,ok,PASS,54000000,69951824,166617328,58441841,75705803,180322655,2,236569152,256028458
2008,tt1000774,Sex and the City,none,ok,PASS,57500000,152647258,415247258,62229738,165203458,449403966,2,567894516,614607424
2008,tt1010048,Slumdog Millionaire,none,notalk,FAIL,14000000,141319928,384519665,15151588,152944384,416148834,2,525839593,569093218
2008,tt0811080,Speed Racer,none,ok,PASS,120000000,43945766,93394462,129870757,47560583,101076746,2,137340228,148637329
2008,tt0942903,Stargate: The Ark of Truth,disagree,dubious,FAIL,7000000,,,7575794,,,2,,
2008,tt0838283,Step Brothers,disagree,notalk,FAIL,65000000,100468793,128468793,70346660,108732985,139036162,2,228937586,247769147
2008,tt0862846,Sunshine Cleaning,none,ok,PASS,5000000,12062558,16462558,5411282,13054780,17816707,2,28525116,30871487
2008,tt0383028,"Synecdoche, New York",none,dubious,FAIL,20000000,3083538,4383538,21645126,3337178,4744112,2,7467076,8081290
2008,tt0936501,Taken,none,ok,PASS,25000000,145000989,226941585,27056408,156928235,245608963,2,371942574,402537198
2008,tt0200465,The Bank Job,none,ok,PASS,20000000,30060660,66143005,21645126,32533339,71583685,2,96203665,104117024
2008,tt0844286,The Brothers Bloom,none,dubious,FAIL,20000000,3531756,5531756,21645126,3822265,5986778,2,9063512,9809043
2008,tt0499448,The Chronicles of Narnia: Prince Caspian,none,ok,PASS,225000000,141621490,419490286,243507670,153270751,453996009,2,561111776,607266760
2008,tt0421715,The Curious Case of Benjamin Button,disagree,dubious,FAIL,160000000,127509326,329809326,173161010,137997773,356938225,2,457318652,494935998
2008,tt0468569,The Dark Knight,disagree,dubious,FAIL,185000000,533345358,1002891358,200217418,577216380,1085385502,2,1536236716,1662601882
2008,tt0970416,The Day the Earth Stood Still,none,ok,PASS,80000000,79366978,233066978,86580505,85895413,252238208,2,312433956,338133621
2008,tt0406759,The Eye,none,ok,PASS,12000000,31418697,56918697,12987076,34003083,61600619,2,88337394,95603702
2008,tt0865556,The Forbidden Kingdom,disagree,notalk,FAIL,55000000,52075270,129075270,59524097,56358790,139692526,2,181150540,196051316
2008,tt0852713,The House Bunny,none,ok,PASS,25000000,48237389,70237389,27056408,52205219,76014858,2,118474778,128220077
2008,tt0887912,The Hurt Locker,disagree,notalk,FAIL,15000000,17017811,49894223,16233845,18417633,53998338,2,66912034,72415971
2008,tt0800080,The Incredible Hulk,none,notalk,FAIL,137500000,134806913,263417913,148810243,145895632,285085699,2,398224826,430981331
2008,tt0981072,The Lucky Ones,none,ok,PASS,14000000,266967,266967,15151588,288927,288927,2,533934,577854
2008,tt0467200,The Other Boleyn Girl,none,ok,PASS,40000000,26814957,77714957,43290252,29020656,84107503,2,104529914,113128159
2008,tt0976051,The Reader,none,notalk,FAIL,32500000,34194407,113019290,35173330,37007113,122315840,2,147213697,159322953
2008,tt0416212,The Secret Life of Bees,none,ok,PASS,11000000,37770162,39984023,11904819,40876996,43272961,2,77754185,84149957
2008,tt1018785,The Sisterhood of the Traveling Pants 2,none,ok,PASS,27000000,44089964,44270131,29220920,47716642,47911629,2,88360095,95628271
2008,tt0482606,The Strangers,disagree,dubious,FAIL,9000000,52597610,83051676,9740307,56924095,89883201,2,135649286,146807296
2008,tt420238,The Tale of Despereaux,none,ok,PASS,60000000,50877145,90482317,64935379,55062111,97925059,2,141359462,152987170
2008,tt0430770,The Women,none,ok,PASS,16000000,26902075,50103808,17316101,29114940,54225162,2,77005883,83340102
2008,tt1125849,The Wrestler,none,notalk,FAIL,6000000,26238243,46634275,6493538,28396504,50470238,2,72872518,78866742
2008,tt0882978,Three Kingdoms: Resurrection of the Dragon,none,notalk,FAIL,20000000,,22139590,21645126,,23960711,2,,
2008,tt0800241,Transsiberian,none,ok,PASS,15000000,2203641,6379575,16233845,2384904,6904335,2,8583216,9289239
2008,tt0942385,Tropic Thunder,none,nowomen,FAIL,90000000,110461307,188163455,97403068,119547447,203641087,2,298624762,323188534
2008,tt1099212,Twilight,disagree,ok,PASS,37000000,192769854,397923934,40043484,208626391,430655689,2,590693788,639282080
2008,tt0985699,Valkyrie,none,notalk,FAIL,90000000,83077762,203902107,97403068,89911432,220674342,2,286979869,310585774
2008,tt0497465,Vicky Cristina Barcelona,none,ok,PASS,16000000,23216709,104504817,17316101,25126430,113100998,2,127721526,138227428
2008,tt0910970,WALL-E,disagree,notalk,FAIL,180000000,223808164,532590994,194806136,242217798,576399965,2,756399158,818617763
2008,tt1185616,Waltz with Bashir,none,nowomen,FAIL,2000000,2283849,11125664,2164513,2471710,12040820,2,13409513,14512530
2008,tt0493464,Wanted,none,notalk,FAIL,75000000,134508551,342416460,81169223,145572728,370582375,2,476925011,516155103
2008,tt0494652,"Welcome Home, Roscoe Jenkins",none,dubious,FAIL,27500000,42436517,43607627,29762049,45927188,47194630,2,86044144,93121818
2008,tt1152850,Wendy and Lucy,none,ok,PASS,300000,865695,1416046,324677,936904,1532525,2,2281741,2469429
2008,tt1033643,What Happens In Vegas,none,ok,PASS,35000000,80277646,218535708,37878971,86880989,236511649,2,298813354,323392638
2008,tt1068680,Yes Man,disagree,notalk,FAIL,50000000,97690976,225990976,54112816,105726675,244580160,2,323681952,350306835
2007,tt1038988,[Rec],none,ok,PASS,2100000,,27117954,2359441,,30468201,2,,
2007,tt0450385,1408,none,ok,PASS,22500000,71985628,131263370,25279728,80878983,147480104,2,203248998,228359087
2007,tt0463854,28 Weeks Later,none,ok,PASS,15000000,28638916,64232714,16853152,32177067,72168247,2,92871630,104345314
2007,tt0381849,3:10 to Yuma,none,nowomen,FAIL,48000000,53606916,71171825,53930087,60229701,79964640,2,124778741,140194341
2007,tt0389722,30 Days of Night,none,men,FAIL,30000000,39568996,80276156,33706305,44457488,90193752,2,119845152,134651240
2007,tt0411061,88 Minutes,none,notalk,FAIL,30000000,16930884,32955399,33706305,19022584,37026824,2,49886283,56049408
2007,tt0445922,Across the Universe,none,ok,PASS,45000000,24343673,29367143,50559457,27351175,32995262,2,53710816,60346437
2007,tt0783233,Atonement,none,ok,PASS,30000000,50980159,130200290,33706305,57278425,146285687,2,181180449,203564112
2007,tt0416508,Becoming Jane,none,ok,PASS,16500000,18663911,39364948,18538467,20969716,44228231,2,58028859,65197947
2007,tt0442933,Beowulf,none,ok,PASS,150000000,82195215,194995215,168531522,92349898,219085603,2,277190430,311435501
2007,tt0445934,Blades of Glory,none,ok,PASS,61000000,118594548,145594548,68536152,133246132,163581806,2,264189096,296827938
2007,tt0398808,Bridge to Terabithia,none,ok,PASS,25000000,82234139,137984788,28088587,92393631,155031909,2,220218927,247425540
2007,tt0283503,Brooklyn Rules,none,ok,PASS,8000000,458232,458232,8988348,514844,514844,2,916464,1029688
2007,tt0423977,Charlie Bartlett,none,men,FAIL,12000000,3950294,5295909,13482522,4438327,5950184,2,9246203,10388511
2007,tt0472062,Charlie Wilson's War,none,ok,PASS,75000000,66661095,119512771,84265761,74896639,134277795,2,186173866,209174434
2007,tt0795368,Death at a Funeral,disagree,ok,PASS,21000000,42739347,48977233,23594413,48019515,55028051,2,91716580,103047566
2007,tt0848557,Diary of the Dead,none,ok,PASS,2750000,952620,5394447,3089745,1070310,6060896,2,6347067,7131206
2007,tt0486822,Disturbia,disagree,ok,PASS,20000000,80209692,117573043,22470870,90119077,132098426,2,197782735,222217503
2007,tt0765443,Eastern Promises,none,ok,PASS,50000000,17181265,55367342,56177174,19303898,62207616,2,72548607,81511514
2007,tt0461770,Enchanted,none,ok,PASS,85000000,127706877,340384141,95501196,143484229,382436383,2,468091018,525920612
2007,tt0486576,Fantastic Four: Rise of the Silver Surfer,none,dubious,FAIL,120000000,131921738,288215319,134825218,148219809,323822443,2,420137057,472042252
2007,tt0452623,Gone Baby Gone,none,ok,PASS,19000000,20300218,34619699,21347326,22808178,38896737,2,54919917,61704915
2007,tt0427327,Hairspray,none,ok,PASS,75000000,118871849,202871849,84265761,133557691,227935344,2,321743698,361493035
2007,tt0373883,Halloween,none,ok,PASS,15000000,58269151,77514401,16853152,65467925,87090800,2,135783552,152558725
2007,tt0367959,Hannibal Rising,none,notalk,FAIL,50000000,27669725,80583311,56177174,31088139,90538854,2,108253036,121626993
2007,tt0373889,Harry Potter and the Order of the Phoenix,disagree,ok,PASS,150000000,292004738,942943935,168531522,328080020,1059438513,2,1234948673,1387518533
2007,tt0465494,Hitman,disagree,nowomen,FAIL,17500000,39687694,99965792,19662011,44590850,112315914,2,139653486,156906764
2007,tt0498353,Hostel: Part II,none,ok,PASS,7500000,17544812,33606409,8426576,19712359,37758262,2,51151221,57470621
2007,tt0425112,Hot Fuzz,disagree,notalk,FAIL,16000000,23618786,81742618,17976696,26536733,91841386,2,105361404,118378119
2007,tt0787475,Hot Rod,none,notalk,FAIL,25000000,13938332,14334401,28088587,15660322,16105323,2,28272733,31765645
2007,tt0480249,I Am Legend,disagree,ok,PASS,150000000,256393010,585410052,168531522,288068696,657733649,2,841803062,945802345
2007,tt0758758,Into the Wild,none,notalk,FAIL,20000000,18354356,56395211,22470870,20621917,63362472,2,74749567,83984389
2007,tt0467406,Juno,none,ok,PASS,7000000,143495265,231450102,7864804,161223170,260044254,2,374945367,421267424
2007,tt0478311,Knocked Up,disagree,ok,PASS,27500000,148761765,219154490,30897446,167140312,246229599,2,367916255,413369911
2007,tt0805564,Lars and the real Girl,none,ok,PASS,12500000,5956480,10553442,14044294,6692364,11857251,2,16509922,18549615
2007,tt0337978,Live Free or Die Hard,none,notalk,FAIL,110000000,134529403,383531464,123589783,151149634,430914277,2,518060867,582063911
2007,tt0465538,Michael Clayton,disagree,men,FAIL,21500000,49033882,92987651,24156185,55091699,104475669,2,142021533,159567368
2007,tt0758766,Music and Lyrics,none,men,FAIL,40000000,50572589,145021477,44941739,56820503,162937935,2,195594066,219758438
2007,tt0477348,No Country for Old Men,none,dubious,FAIL,25000000,74273505,164051250,28088587,83449513,184318713,2,238324755,267768226
2007,tt0481141,No Reservations,none,ok,PASS,28000000,43107979,91665799,31459218,48433689,102990511,2,134773778,151424200
2007,tt1179904,Paranormal Activity,none,dubious,FAIL,450000,107918810,194183034,505595,121251476,218173082,2,302101844,339424558
2007,tt0808417,Persepolis,none,ok,PASS,7300000,4443403,22742498,8201867,4992356,25552185,2,27185901,30544541
2007,tt0449088,Pirates of the Caribbean: At World's End,none,ok,PASS,300000000,309420425,960996492,337063045,347647302,1079721346,2,1270416917,1427368648
2007,tt0477071,Premonition,none,ok,PASS,20000000,47852604,81461343,22470870,53764481,91525361,2,129313947,145289842
2007,tt0382932,Ratatouille,disagree,nowomen,FAIL,150000000,206445654,626549695,168531522,231950669,703955827,2,832995349,935906496
2007,tt0432021,Resident Evil: Extinction,none,ok,PASS,45000000,50648679,146162920,50559457,56905993,164220396,2,196811599,221126389
2007,tt00293564,Rush Hour 3,none,notalk,FAIL,180000000,140125968,253025968,202237827,157437618,284285677,2,393151936,441723295
2007,tt0822854,Shooter,disagree,notalk,FAIL,60000000,47003582,95703582,67412609,52810568,107527136,2,142707164,160337704
2007,tt0413267,Shrek the Third,disagree,ok,PASS,160000000,322719944,807330936,179766957,362589890,907071412,2,1130050880,1269661302
2007,tt0964587,St. Trinian's,none,ok,PASS,11400000,15000,22446568,12808396,16853,25219695,2,22461568,25236548
2007,tt0486655,Stardust,none,ok,PASS,70000000,38634938,135556675,78648044,43408033,152303819,2,174191613,195711852
2007,tt0448134,Sunshine,disagree,notalk,FAIL,40000000,3688560,32030610,44941739,4144258,35987783,2,35719170,40132041
2007,tt0829482,Superbad,disagree,notalk,FAIL,17500000,121463226,169863226,19662011,136469216,190848721,2,291326452,327317937
2007,tt0815244,Sydney White,none,ok,PASS,16500000,11892415,13636339,18538467,13361645,15321020,2,25528754,28682665
2007,tt0780622,Teeth,disagree,dubious,FAIL,2000000,347578,2350641,2247087,390519,2641047,2,2698219,3031566
2007,tt0825232,The Bucket List,none,notalk,FAIL,45000000,93466502,174310293,50559457,105013679,195845194,2,267776795,300858873
2007,tt0385752,The Golden Compass,none,ok,PASS,205000000,70107728,372234864,230326414,78769081,418222056,2,442342592,496991137
2007,tt0419887,The Kite Runner,none,nowomen,FAIL,20000000,15800078,74180745,22470870,17752075,83345293,2,89980823,101097368
2007,tt0756683,The Man from Earth,none,notalk,FAIL,200000,,,224709,,,2,,
2007,tt0425430,The Messengers,none,ok,PASS,16000000,35374833,53774833,17976696,39745163,60418363,2,89149666,100163526
2007,tt0884328,The Mist,none,ok,PASS,13000000,25593755,54777490,14606065,28755697,61544892,2,80371245,90300589
2007,tt0481369,The Number 23,none,notalk,FAIL,32000000,35193167,77593167,35953391,39541053,87179297,2,112786334,126720350
2007,tt0775529,The Savages,none,ok,PASS,9000000,6623082,10642023,10111891,7441321,11956776,2,17265105,19398097
2007,tt0780607,The Signal,none,men,FAIL,50000,251150,406299,56177,282178,456495,2,657449,738673
2007,tt0462538,The Simpsons Movie,none,ok,PASS,72500000,183135014,527071022,81456903,205760152,592187212,2,710206036,797947364
2007,tt0857191,The Visitor,none,dubious,FAIL,4000000,9427026,19174817,4494174,10591674,21543741,2,28601843,32135415
2007,tt0469494,There Will Be Blood,disagree,nowomen,FAIL,25000000,40222514,77208711,28088587,45191743,86747344,2,117431225,131939087
2007,tt0453556,TMNT,disagree,notalk,FAIL,35000000,54149098,96096018,39324022,60838866,107968055,2,150245116,168806921
2007,tt0418279,Transformers,disagree,notalk,FAIL,151000000,319246193,708272592,169655066,358686980,795775055,2,1027518785,1154462035
2007,tt0861739,Tropa de Elite,disagree,ok,PASS,6537890,8744,14319195,7345604,9824,16088238,2,14327939,16098062
2007,tt0473308,Waitress,none,ok,PASS,1500000,19097550,22217183,1685315,21456928,24961971,2,41314733,46418899
2007,tt0498399,We Own the Night,none,nowomen,FAIL,28000000,28563179,55307857,31459218,32091974,62140782,2,83871036,94232756
2007,tt0496436,White Noise 2: The Light,none,notalk,FAIL,10000000,,8243567,11235435,,9262006,2,,
2006,tt0416449,300,disagree,nowomen,FAIL,60000000,210614939,454161935,69347781,243427977,524918705,2,664776874,768346682
2006,tt0405296,A Scanner Darkly,none,notalk,FAIL,20000000,5501616,7405084,23115927,6358748,8558769,2,12906700,14917517
2006,tt0437800,Akeelah and the Bee,none,ok,PASS,8000000,18848430,18959424,9246371,21784947,21913233,2,37807854,43698180
2006,tt0429591,Aquamarine,none,ok,PASS,12000000,18597342,22978953,13869556,21494740,26558990,2,41576295,48053730
2006,tt0416496,Bandidas,none,ok,PASS,35000000,,18400000,40452872,,21266653,2,,
2006,tt0454082,Black Christmas,none,ok,PASS,9000000,16235738,16235738,10402167,18765207,18765207,2,32471476,37530414
2006,tt0450259,Blood Diamond,none,notalk,FAIL,100000000,57377916,171377916,115579635,66317186,198077969,2,228755832,264395155
2006,tt0479647,"Bon Cop, Bad Cop",none,notalk,FAIL,8000000,12671300,12671300,9246371,14645442,14645442,2,25342600,29290884
2006,tt0443453,Borat: Cultural Learnings of America for Make Benefit Glorious Nation of Kazakhstan,none,notalk,FAIL,18000000,128505958,261572744,20804334,148526717,302324822,2,390078702,450851539
2006,tt0470705,Bug,none,ok,PASS,4000000,7006708,7006708,4623185,8098328,8098328,2,14013416,16196656
2006,tt0317219,Cars,disagree,notalk,FAIL,70000000,244082982,461667967,80905744,282110219,533594150,2,705750949,815704369
2006,tt0381061,Casino Royale,none,notalk,FAIL,102000000,167365000,596365000,117891227,193439856,689276488,2,763730000,882716344
2006,tt0206634,Children of Men,none,ok,PASS,76000000,35552383,69450202,87840522,41091314,80270290,2,105002585,121361604
2006,tt0424345,Clerks II,none,dubious,FAIL,5000000,24148068,25894473,5778982,27910249,29928737,2,50042541,57838986
2006,tt0479884,Crank,none,nowomen,FAIL,12000000,27838408,43924923,13869556,32175530,50768266,2,71763331,82943796
2006,tt0405094,Das Leben Der Anderen,disagree,nowomen,FAIL,2000000,11284657,81197047,2311593,13042765,93847250,2,92481704,106890015
2006,tt0398913,DOA: Dead or Alive,none,ok,PASS,30000000,480314,7756224,34673890,555145,8964615,2,8236538,9519760
2006,tt0457430,El laberinto del fauno (Pan's Labyrinth),disagree,ok,PASS,16000000,37634615,87041569,18492742,43497951,100602327,2,124676184,144100278
2006,tt0449010,Eragon,none,notalk,FAIL,100000000,75030163,249488115,115579635,86719588,288357452,2,324518278,375077040
2006,tt0457572,Fido,none,men,FAIL,8000000,298110,419801,9246371,344554,485204,2,717911,829758
2006,tt0414982,Final Destination 3,none,ok,PASS,25000000,54098051,112798051,28894909,62526330,130371575,2,166896102,192897905
2006,tt0424095,Flushed Away,none,nowomen,FAIL,149000000,64665672,177665672,172213656,74740347,205345335,2,242331344,280085682
2006,tt0470765,For Your Consideration,none,ok,PASS,12000000,5549923,5549923,13869556,6414581,6414581,2,11099846,12829162
2006,tt0436331,Friends with Money,none,ok,PASS,6500000,13368437,17518322,7512676,15451191,20247613,2,30886759,35698804
2006,tt0438097,Ice Age: The Meltdown,none,notalk,FAIL,75000000,195330621,651899282,86684726,225762418,753462808,2,847229903,979225226
2006,tt0417225,Idlewild,none,ok,PASS,15000000,12669914,12669914,17336945,14643840,14643840,2,25339828,29287680
2006,tt0454848,Inside Man,disagree,dubious,FAIL,50000000,88634237,184634237,57789817,102443127,213399577,2,273268474,315842704
2006,tt0493430,Jackass Number Two,none,notalk,FAIL,11000000,72778712,85278712,12713760,84117369,98564824,2,158057424,182682193
2006,tt0452637,Lady in the Water,none,men,FAIL,75000000,42285169,72785169,86684726,48873044,84124832,2,115070338,132997876
2006,tt0408985,Last Holiday,none,ok,PASS,45000000,38399961,43343247,52010836,44382535,50095967,2,81743208,94478502
2006,tt0498380,Letters from Iwo Jima,none,notalk,FAIL,13000000,13756082,68756082,15025353,15899229,79468028,2,82512164,95367257
2006,tt0404203,Little Children,none,ok,PASS,14000000,5463019,14763019,16181149,6314137,17063043,2,20226038,23377180
2006,tt0449059,Little Miss Sunshine,none,ok,PASS,8000000,59891098,100550977,9246371,69221912,116216452,2,160442075,185438364
2006,tt0490166,London To Brighton,none,ok,PASS,825000,,610776,953532,,705933,2,,
2006,tt0425210,Lucky Number Slevin,disagree,notalk,FAIL,27000000,22495466,55495466,31206501,26000177,64141457,2,77990932,90141634
2006,tt0483726,Man of the Year,none,notalk,FAIL,20000000,37442180,41342180,23115927,43275535,47783141,2,78784360,91058676
2006,tt0422720,Marie Antoinette,none,ok,PASS,40000000,15962471,60862471,46231854,18449366,70344622,2,76824942,88793988
2006,tt0482546,Miss Potter,none,ok,PASS,30000000,3005605,35891257,34673890,3473867,41482984,2,38896862,44956851
2006,tt0385880,Monster House,none,ok,PASS,75000000,73661010,141267370,86684726,85137126,163276310,2,214928380,248413436
2006,tt0457510,Nacho Libre,disagree,nowomen,FAIL,32000000,80197993,99296462,36985483,92692547,114766488,2,179494455,207459035
2006,tt0477347,Night at the Museum,none,ok,PASS,110000000,250863268,574480841,127137598,289946849,663982857,2,825344109,953929706
2006,tt0465551,Notes on a Scandal,none,ok,PASS,27500000,17510118,49752391,31784400,20238130,57503632,2,67262509,77741762
2006,tt0907657,Once,none,men,FAIL,150000,9445857,18997174,173369,10917487,21956864,2,28443031,32874351
2006,tt0400717,Open Season,none,notalk,FAIL,85000000,85105259,189901703,98242689,98364347,219487695,2,275006962,317852042
2006,tt0401711,Paris je t'aime,none,dubious,FAIL,13000000,4857374,4857374,15025353,5614135,5614135,2,9714748,11228270
2006,tt0396171,Perfume: The Story of a Murderer,none,ok,PASS,63700000,2223293,133603463,73624227,2569674,154418394,2,135826756,156988068
2006,tt0383574,Pirates of the Caribbean: Dead Man's Chest,disagree,men,FAIL,225000000,423315812,1060615812,260054178,489266869,1225855881,2,1483931624,1715122750
2006,tt0409182,Poseidon,none,men,FAIL,160000000,60674817,181674817,184927415,70127732,209979090,2,242349634,280106822
2006,tt0451176,Quinceanera,none,ok,PASS,400000,1692693,2522787,462319,1956408,2915828,2,4215480,4872236
2006,tt0405508,Rang De Basanti,none,ok,PASS,5300000,2197694,29197694,6125721,2540087,33746588,2,31395388,36286675
2006,tt0439289,Running with Scissors,none,ok,PASS,12000000,6860000,8706701,13869556,7928763,10063173,2,15566701,17991936
2006,tt0454945,She's the Man,disagree,men,FAIL,25000000,33889159,55279608,28894909,39168966,63891969,2,89168767,103060935
2006,tt0423169,Sherrybaby,none,dubious,FAIL,2000000,199176,622806,2311593,230207,719837,2,821982,950044
2006,tt0367027,Shortbus,none,ok,PASS,2000000,1985292,1985292,2311593,2294593,2294593,2,3970584,4589186
2006,tt0384537,Silent Hill,none,ok,PASS,50000000,46982632,99982632,57789817,54302354,115559561,2,146965264,169861915
2006,tt0439815,Slither,none,ok,PASS,15250000,7802450,12930343,17625894,9018043,14944843,2,20732793,23962886
2006,tt0475394,Smokin' Aces,disagree,dubious,FAIL,17000000,35662731,56047261,19648538,41218854,64779219,2,91709992,105998073
2006,tt0417148,Snakes on a Plane,none,ok,PASS,33000000,34020814,62020814,38141279,39321133,71683430,2,96041628,111004563
2006,tt0405336,Southland Tales,none,ok,PASS,17000000,275380,364607,19648538,318283,421411,2,639987,739694
2006,tt0430634,Stick It,none,ok,PASS,20000000,26910736,30399714,23115927,31103330,35135878,2,57310450,66239208
2006,tt0420223,Stranger Than Fiction,none,ok,PASS,30000000,40435190,45235190,34673890,46734845,52282667,2,85670380,99017512
2006,tt0348150,Superman Returns,none,notalk,FAIL,232000000,200120000,390874000,268144752,231297965,451770741,2,590994000,683068706
2006,tt0446046,Take the Lead,none,ok,PASS,30000000,34742066,65390493,34673890,40154753,75578093,2,100132559,115732846
2006,tt0429589,The Ant Bully,none,men,FAIL,45000000,28142535,49610898,52010836,32527039,57340095,2,77753433,89867134
2006,tt0452594,The Break Up,none,notalk,FAIL,52000000,118806699,202944203,60101410,137316349,234562168,2,321750902,371878517
2006,tt0382625,The Da Vinci Code,none,notalk,FAIL,125000000,217536138,767820459,144474543,251427474,887444081,2,985356597,1138871555
2006,tt0783238,The Dead Girl,none,ok,PASS,3300000,19875,19875,3814128,22971,22971,2,39750,45942
2006,tt0407887,The Departed,none,notalk,FAIL,90000000,133311000,290539042,104021671,154080367,335803963,2,423850042,489884330
2006,tt0458352,The Devil Wears Prada,none,ok,PASS,35000000,124740460,326551094,40452872,144174568,377426561,2,451291554,521601129
2006,tt0414993,The Fountain,none,dubious,FAIL,35000000,10144010,15461638,40452872,11724410,17870505,2,25605648,29594915
2006,tt0433386,The Grudge 2,none,ok,PASS,20000000,39143839,70743839,23115927,45242306,81765471,2,109887678,127007777
2006,tt0464049,The History Boys,none,notalk,FAIL,3700000,2730296,13425589,4276446,3155666,15517247,2,16155885,18672913
2006,tt0457939,The Holiday,disagree,ok,PASS,85000000,63280000,205190324,98242689,73138793,237158227,2,268470324,310297020
2006,tt0468492,The Host,none,ok,PASS,50000000,26623701,58188384,57789817,30771576,67253922,2,84812085,98025498
2006,tt0443543,The Illusionist,none,nowomen,FAIL,16500000,39868642,83792062,19070640,46080031,96846559,2,123660704,142926590
2006,tt0410297,The Lake House,none,dubious,FAIL,40000000,52330111,114830111,46231854,60482951,132720223,2,167160222,193203174
2006,tt0446755,The Painted Veil,none,dubious,FAIL,19400000,8060487,15118795,22422449,9316281,17474248,2,23179282,26790529
2006,tt0482571,The Prestige,none,notalk,FAIL,40000000,53089891,107896006,46231854,61361102,124705810,2,160985897,186066912
2006,tt0454921,The Pursuit of Happyness,disagree,nowomen,FAIL,55000000,162586036,307325633,63568799,187916346,355205844,2,469911669,543122190
2006,tt0436697,The Queen,disagree,dubious,FAIL,15000000,56441711,128885873,17336945,65235123,148965821,2,185327584,214200944
2006,tt0460989,The Wind That Shakes the Barley,disagree,notalk,FAIL,8300000,1829142,25670174,9593110,2114116,29669493,2,27499316,31783609
2006,tt0370032,Ultraviolet,none,notalk,FAIL,30000000,18522064,20722064,34673890,21407734,23950486,2,39244128,45358220
2006,tt0441909,Volver,none,ok,PASS,9400000,12899867,85599867,10864486,14909619,98936014,2,98499734,113845633
2006,tt0758794,We Are Marshall,none,notalk,FAIL,65000000,43545364,43545364,75126763,50329573,50329573,2,87090728,100659146
2006,tt0455857,When a Stranger Calls,none,ok,PASS,15000000,47860214,66944472,17336945,55316660,77374176,2,114804686,132690836
2006,tt0477139,Wristcutters: A Love Story,none,notalk,FAIL,1000000,446165,460136,1155796,515676,531824,2,906301,1047500
2006,tt0376994,X-Men: The Last Stand,none,ok,PASS,210000000,234362462,459359555,242717233,270875277,530926095,2,693722017,801801372
2006,tt0463034,"You, Me and Dupree",none,notalk,FAIL,54000000,75802010,130402010,62413003,87611686,150718167,2,206204020,238329853
2006,tt0383060,Zoom,none,ok,PASS,35000000,11989328,12506188,40452872,13857222,14454606,2,24495516,28311828
2006,tt0389557,Zwartboek,none,ok,PASS,22000000,4398532,27238354,25427520,5083807,31481990,2,31636886,36565797
2005,tt0402022,AEon Flux,none,ok,PASS,55000000,25857987,47953341,65616822,30849435,57209924,2,73811328,88059359
2005,tt0398712,Assault on Precinct 13,none,ok,PASS,30000000,20040895,36040895,35790994,23909452,42997982,2,56081790,66907434
2005,tt0372784,Batman Begins,none,notalk,FAIL,150000000,205343774,373298774,178954969,244981925,445357804,2,578642548,690339729
2005,tt0388500,Beauty Shop,none,ok,PASS,25000000,36351350,38351350,29825828,43368365,45754431,2,74702700,89122796
2005,tt0374536,Bewitched,none,ok,PASS,80000000,63313159,131159306,95442650,75534696,156477397,2,194472465,232012093
2005,tt0383222,BloodRayne,none,dubious,FAIL,25000000,2405420,3605420,29825828,2869746,4301386,2,6010840,7171132
2005,tt0357507,Boogeyman,none,men,FAIL,20000000,46752382,67192859,23860663,55777141,80163307,2,113945241,135940448
2005,tt0439478,Boynton Beach Club,none,ok,PASS,2900000,3127472,3127472,3459796,3731178,3731178,2,6254944,7462356
2005,tt0393109,Brick,none,notalk,FAIL,450000,2075743,4087493,536865,2476430,4876515,2,6163236,7352945
2005,tt0388795,Brokeback Mountain,none,notalk,FAIL,13900000,83043761,174097801,16583160,99073958,207704444,2,257141562,306778402
2005,tt0379725,Capote,none,dubious,FAIL,7000000,28750530,49924079,8351232,34300335,59561080,2,78674609,93861415
2005,tt0367594,Charlie and the Chocolate Factory,none,ok,PASS,150000000,206459076,474459076,178954969,246312517,566045396,2,680918152,812357913
2005,tt0451094,Chinjeolhan geumjassi,none,ok,PASS,4500000,211667,23471871,5368649,252526,28002720,2,23683538,28255246
2005,tt0352248,Cinderella Man,none,men,FAIL,88000000,61649911,108539911,104986915,73550386,129491710,2,170189822,203042096
2005,tt0393162,Coach Carter,none,ok,PASS,45000000,67264877,76669806,53686491,80249227,91469619,2,143934683,171718846
2005,tt0360486,Constantine,none,notalk,FAIL,75000000,75976178,230884728,89477485,90642097,275453129,2,306860906,366095226
2005,tt0435623,Conversations with Other Women,disagree,nowomen,FAIL,450000,379418,909061,536865,452658,1084540,2,1288479,1537198
2005,tt0121164,Corpse Bride,none,dubious,FAIL,30000000,53359111,114770654,35790994,63659187,136925192,2,168129765,200584379
2005,tt0257516,Cursed,none,ok,PASS,35000000,19294901,25114901,41756160,23019456,29962909,2,44409802,52982365
2005,tt0342258,Danny the dog,none,notalk,FAIL,43000000,24537621,49037621,51300425,29274195,58503506,2,73575242,87777701
2005,tt0382628,Dark Water,none,ok,PASS,60000000,25473093,49473093,71581988,30390244,59023039,2,74946186,89413283
2005,tt0342272,Dear Wendy,none,notalk,FAIL,8000000,23106,446438,9544265,27566,532615,2,469544,560181
2005,tt0421054,Domino,none,ok,PASS,50000000,10169202,22969202,59651656,12132195,27403019,2,33138404,39535214
2005,tt0419706,Doom,none,notalk,FAIL,70000000,28212337,54612337,83512319,33658253,65154327,2,82824674,98812580
2005,tt0120667,Fantastic Four,disagree,notalk,FAIL,87500000,154696080,330717080,104390399,184557548,394556433,2,485413160,579113981
2005,tt0408790,Flightplan,none,ok,PASS,55000000,89706988,225706988,65616822,107023409,269275914,2,315413976,376299323
2005,tt0369441,Fun with Dick and Jane,none,ok,PASS,140000000,110550000,201798116,167024638,131889812,240751838,2,312348116,372641650
2005,tt0433383,"Good Night, and Good Luck.",none,notalk,FAIL,7000000,31501218,56586901,8351232,37581997,67510048,2,88088119,105092045
2005,tt0424136,Hard Candy,disagree,ok,PASS,950000,1024640,8267066,1133381,1222429,9862884,2,9291706,11085313
2005,tt0330373,Harry Potter and the Goblet of Fire,disagree,notalk,FAIL,150000000,290013036,896911078,178954969,345995160,1070044630,2,1186924114,1416039790
2005,tt0400497,Herbie Fully Loaded,none,ok,PASS,50000000,66010682,144110682,59651656,78752930,171928818,2,210121364,250681748
2005,tt0382077,Hide and Seek,none,ok,PASS,25000000,51100486,123100486,29825828,60964573,146862958,2,174200972,207827531
2005,tt0386588,Hitch,none,men,FAIL,55000000,177784257,366784257,65616822,212102508,437585770,2,544568514,649688278
2005,tt0443536,Hoodwinked!,none,ok,PASS,17500000,51386611,109843390,20878080,61305929,131046803,2,161230001,192352732
2005,tt0450278,Hostel,none,notalk,FAIL,4800000,47326473,82241110,5726559,56462050,98116369,2,129567583,154578419
2005,tt0410097,Hustle & Flow,none,dubious,FAIL,2800000,22202809,23563727,3340493,26488687,28112307,2,45766536,54600994
2005,tt0396652,Ice Princess,none,ok,PASS,25000000,24381334,25732334,29825828,29087739,30699527,2,50113668,59787266
2005,tt0418763,Jarhead,none,nowomen,FAIL,72000000,62647540,96947540,85898385,74740591,115661627,2,159595080,190402218
2005,tt0418773,Junebug,none,ok,PASS,1000000,2678010,3557954,1193033,3194955,4244757,2,6235964,7439712
2005,tt0425123,Just Like Heaven,none,ok,PASS,58000000,48318130,100687083,69195921,57645130,120123026,2,149005213,177768156
2005,tt0360717,King Kong,none,nowomen,FAIL,207000000,218080025,550517357,246957858,260176695,656785445,2,768597382,916962140
2005,tt0320661,Kingdom of Heaven,none,nowomen,FAIL,110000000,47398413,218853353,131233644,56547877,261099301,2,266251766,317647178
2005,tt0373469,Kiss Kiss Bang Bang,none,notalk,FAIL,15000000,4235837,13105837,17895497,5053494,15635698,2,17341674,20689192
2005,tt0399295,Lord of War,none,men,FAIL,42000000,24149632,62142629,50107391,28811311,74138215,2,86292261,102949526
2005,tt0351283,Madagascar,none,nowomen,FAIL,75000000,193595521,556559566,89477485,230965870,663994001,2,750155087,894959871
2005,tt0331933,Man of the House,none,ok,PASS,50000000,19699706,22099706,59651656,23502402,26365681,2,41799412,49868083
2005,tt0416320,Match Point,none,ok,PASS,15000000,23089926,87989926,17895497,27547047,104974897,2,111079852,132521944
2005,tt0415978,Me and You and Everyone We Know,none,ok,PASS,2000000,3885134,8425527,2386066,4635094,10051933,2,12310661,14687027
2005,tt0397535,Memoirs of a Geisha,none,ok,PASS,85000000,57010853,161510853,101407816,68015836,192687798,2,218521706,260703634
2005,tt0366780,MirrorMask,none,ok,PASS,4000000,864959,963224,4772133,1031925,1149158,2,1828183,2181083
2005,tt0385307,Miss Congeniality 2: Armed & Fabulous,none,ok,PASS,60000000,48478006,101382396,71581988,57835867,120952557,2,149860402,178788424
2005,tt0356910,Mr. & Mrs. Smith,none,men,FAIL,110000000,186336279,478336279,131233644,222305354,570671028,2,664672558,792976382
2005,tt0408306,Munich,none,notalk,FAIL,75000000,47379090,130279090,89477485,56524824,155427270,2,177658180,211952094
2005,tt0395972,North Country,none,ok,PASS,30000000,18324242,25224242,35790994,21861428,30093356,2,43548484,51954784
2005,tt0380599,Oliver Twist,none,notalk,FAIL,65000000,2070920,26670920,77547153,2470676,31819291,2,28741840,34289967
2005,tt0414387,Pride and Prejudice,none,ok,PASS,28000000,38372662,120918508,33404928,45779857,144259786,2,159291170,190039643
2005,tt0377107,Proof,none,ok,PASS,20000000,7535331,8284331,23860663,8989900,9883481,2,15819662,18873381
2005,tt0421239,Red Eye,none,ok,PASS,26000000,57891803,95555805,31018861,69066839,114001241,2,153447608,183068080
2005,tt0294870,Rent,none,ok,PASS,40000000,29077547,31670620,47721325,34690477,37784099,2,60748167,72474576
2005,tt0358082,Robots,disagree,notalk,FAIL,80000000,128200012,260700012,95442650,152946861,311023751,2,388900024,463970612
2005,tt0432348,Saw II,disagree,dubious,FAIL,5000000,87025093,152925093,5965166,103823819,182444702,2,239950186,286268521
2005,tt0379786,Serenity,none,ok,PASS,39000000,25514517,38514517,46528292,30439664,45949095,2,64029034,76388759
2005,tt0338427,Shopgirl,none,men,FAIL,7500000,10284523,11758418,8947748,12269777,14028182,2,22042941,26297959
2005,tt0401792,Sin City,disagree,ok,PASS,40000000,74103820,158753820,47721325,88408312,189398567,2,232857640,277806879
2005,tt0474361,Sisters in Law,none,ok,PASS,300000,33312,33312,357910,39742,39742,2,66624,79484
2005,tt0405325,Sky High,none,ok,PASS,60000000,63939454,81627454,71581988,76281887,97384257,2,145566908,173666144
2005,tt0362165,Son of the Mask,none,notalk,FAIL,100000000,17018422,59918422,119303313,20303541,71484662,2,76936844,91788203
2005,tt0121766,Star Wars: Episode III - Revenge of the Sith,disagree,notalk,FAIL,115000000,380270577,848998877,137198810,453675396,1012883787,2,1229269454,1466559183
2005,tt0382992,Stealth,none,notalk,FAIL,138000000,32116746,76416746,164638572,38316342,91167710,2,108533492,129484052
2005,tt0369994,Strangers with Candy,none,ok,PASS,2000000,2072645,2077844,2386066,2472734,2478937,2,4150489,4951671
2005,tt0427944,Thank You for Smoking,none,notalk,FAIL,7500000,24793509,40016662,8947748,29579478,47741203,2,64810171,77320681
2005,tt0405422,The 40 Year Old Virgin,disagree,men,FAIL,26000000,109449237,177360047,31018861,130576566,211596412,2,286809284,342172978
2005,tt0424774,The Adventures of Sharkboy and Lavagirl 3-D,none,notalk,FAIL,50000000,39177684,69425966,59651656,46740275,82827477,2,108603650,129567752
2005,tt0384806,The Amityville Horror,none,ok,PASS,18500000,65233369,109175673,22071113,77825570,130250195,2,174409042,208075765
2005,tt0357110,The Ballad of Jack and Rose,none,ok,PASS,1500000,712294,1126258,1789550,849790,1343663,2,1838552,2193453
2005,tt0363771,"The Chronicles of Narnia: The Lion, the Witch and the Wardrobe",none,ok,PASS,180000000,291710957,748806957,214745963,348020836,893351507,2,1040517914,1241372343
2005,tt0387131,The Constant Gardener,none,ok,PASS,25500000,33579798,81079798,30422345,40061811,96730885,2,114659596,136792696
2005,tt0435625,The Descent,none,ok,PASS,7000000,26024456,57029609,8351232,31048038,68038213,2,83054065,99086251
2005,tt0395584,The Devil's Rejects,none,ok,PASS,7000000,17044981,20940428,8351232,20335227,24982624,2,37985409,45317851
2005,tt0404032,The Exorcism of Emily Rose,none,ok,PASS,18000000,75072454,144587700,21474596,89563925,172497916,2,219660154,262061841
2005,tt0432291,The Fog,none,ok,PASS,18000000,29511112,37048526,21474596,35207734,44200119,2,66559638,79407853
2005,tt0371724,The Hitchhiker's Guide to the Galaxy,disagree,notalk,FAIL,45000000,51019112,104019112,53686491,60867491,124098247,2,155038224,184965738
2005,tt0399201,The Island,none,ok,PASS,120000000,35818913,163018913,143163975,42733150,194486964,2,198837826,237220114
2005,tt0366627,The Jacket,none,men,FAIL,28500000,6301131,15452978,34001444,7517458,18435915,2,21754109,25953373
2005,tt0386140,The Legend of Zorro,none,notalk,FAIL,80000000,45575336,141475336,95442650,54372886,168784763,2,187050672,223157649
2005,tt0402399,The New World,none,dubious,FAIL,30000000,12712093,26184400,35790994,15165948,31238857,2,38896493,46404805
2005,tt0377109,The Ring Two,none,ok,PASS,50000000,75941727,161941727,59651656,90600996,193201845,2,237883454,283802841
2005,tt0397101,The Skeleton Key,none,ok,PASS,40000000,47907715,92256918,47721325,57155491,110065560,2,140164633,167221051
2005,tt0367089,The Squid and the Whale,none,men,FAIL,1500000,7372734,11191423,1789550,8795916,13351738,2,18564157,22147654
2005,tt0372532,The Wedding Date,none,ok,PASS,15000000,31726995,47175038,17895497,37851356,56281383,2,78902033,94132739
2005,tt0407265,Transamerica,none,ok,PASS,1000000,9015303,16553163,1193033,10755555,19748472,2,25568466,30504027
2005,tt0423409,Tristram Shandy: A Cock and Bull Story,none,men,FAIL,4750000,1253413,3061763,5666907,1495363,3652785,2,4315176,5148148
2005,tt0434409,V for Vendetta,disagree,ok,PASS,50000000,70511035,129231542,59651656,84122001,154177511,2,199742577,238299512
2005,tt0348333,Waiting...,none,ok,PASS,1125000,16124543,18673274,1342162,19237114,22277835,2,34797817,41514949
2005,tt0358273,Walk the Line,none,ok,PASS,29000000,119519402,187707495,34597961,142590606,223941260,2,307226897,366531866
2005,tt0407304,War of the Worlds,none,notalk,FAIL,132000000,234280354,606836535,157480373,279504224,723976090,2,841116889,1003480314
2005,tt0240200,Water,none,ok,PASS,3000000,5529144,8119205,3579099,6596452,9686481,2,13648349,16282933
2005,tt0375210,White Noise,none,notalk,FAIL,10000000,56094360,92094360,11930331,66922430,109871622,2,148188720,176794052
2005,tt0443295,"Yours, Mine and Ours",none,ok,PASS,45000000,53359917,72359917,53686491,63660149,86327778,2,125719834,149987927
2005,tt0406375,Zathura: A Space Adventure,none,nowomen,FAIL,65000000,28045540,58545540,77547153,33459258,69846769,2,86591080,103306027
2004,tt0337563,13 Going on 30,none,ok,PASS,30000000,57139723,96439723,36995786,70464299,118928779,3,153579446,189393078
2004,tt0212712,2046,none,ok,PASS,12000000,1442338,19202856,14798315,1778681,23680825,3,20645194,25459506
2004,tt0343660,50 First Dates,disagree,men,FAIL,75000000,120776832,196324496,92489466,148941129,242105970,3,317101328,391047099
2004,tt0356470,A Cinderella Story,none,ok,PASS,19000000,51438175,70067909,23430665,63433191,86407246,3,121506084,149840437
2004,tt0359423,A Home at the End of The World,none,dubious,FAIL,6500000,1029017,1033810,8015754,1268976,1274887,3,2062827,2543863
2004,tt0344510,A Very Long Engagement,none,ok,PASS,55000000,6167817,59606587,67825608,7606108,73506419,3,65774404,81112527
2004,tt0357413,Anchorman: The Legend of Ron Burgundy,disagree,men,FAIL,25000000,84136909,89366354,30829822,103757037,110205951,3,173503263,213962988
2004,tt0327437,Around the World in 80 Days,none,notalk,FAIL,110000000,24004159,72004159,135651216,29601758,88795016,3,96008318,118396774
2004,tt0370263,AVP: Alien vs. Predator,disagree,dubious,FAIL,70000000,80281096,172543519,86323501,99002076,212779439,3,252824615,311781515
2004,tt0414852,Banlieue 13,none,nowomen,FAIL,15000000,1200216,11208291,18497893,1480098,13821985,3,12408507,15302083
2004,tt0381681,Before Sunset,none,nowomen,FAIL,2000000,5792822,11293790,2466386,7143667,13927421,3,17086612,21071088
2004,tt0317198,Bridget Jones: The Edge of Reason,none,ok,PASS,50000000,40203020,263894551,61659644,49578078,325432881,3,304097571,375010959
2004,tt0327554,Catwoman,none,ok,PASS,100000000,40202379,82145379,123319288,49577287,101301096,3,122347758,150878383
2004,tt0337921,Cellular,none,ok,PASS,45000000,32003620,61475984,55493679,39466636,75811746,3,93479604,115278382
2004,tt0376541,Closer,none,ok,PASS,35000000,33987757,115476509,43161751,41913460,142404808,3,149464266,184318268
2004,tt0369339,Collateral,disagree,nowomen,FAIL,60000000,100170152,217670152,73991573,123529118,268429281,3,317840304,391958399
2004,tt0345074,Connie and Carla,none,ok,PASS,20000000,8047525,8047525,24663858,9924151,9924151,3,16095050,19848302
2004,tt0375679,Crash,none,ok,PASS,7303082,55334418,101173038,9006109,68238010,124765870,3,156507456,193003880
2004,tt0367631,D.E.B.S.,none,ok,PASS,3500000,96793,96793,4316175,119364,119364,3,193586,238728
2004,tt0363547,Dawn of the Dead,none,ok,PASS,28000000,58990765,103452875,34529401,72746991,127577349,3,162443640,200324340
2004,tt0364725,Dodgeball: A True Underdog Story,none,ok,PASS,30000000,114326736,167791704,36995786,140986916,206919534,3,282118440,347906450
2004,tt0327679,Ella Enchanted,none,ok,PASS,35000000,22913677,22913677,43161751,28256983,28256983,3,45827354,56513966
2004,tt0338013,Eternal Sunshine of the Spotless Mind,none,men,FAIL,20000000,34366518,72993444,24663858,42380545,90014995,3,107359962,132395540
2004,tt0349416,Eulogy,none,ok,PASS,10000000,70527,70527,12331929,86973,86973,3,141054,173946
2004,tt0308644,Finding Neverland,none,ok,PASS,25000000,51676606,115036108,30829822,63727222,141861709,3,166712714,205588931
2004,tt0377062,Flight of the Phoenix,none,nowomen,FAIL,75000000,21009180,34009180,92489466,25908371,41939879,3,55018360,67848250
2004,tt0333766,Garden State,none,ok,PASS,2500000,26782316,36028802,3082982,33027761,44430462,3,62811118,77458223
2004,tt0366551,Harold and Kumar Go to White Castle,disagree,ok,PASS,9000000,18225165,18225165,11098736,22475144,22475144,3,36450330,44950288
2004,tt0304141,Harry Potter and the Prisoner of  Azkaban,none,ok,PASS,130000000,249538952,796688549,160315074,307729658,982470644,3,1046227501,1290200302
2004,tt0167190,Hellboy,none,notalk,FAIL,60000000,59623958,99823958,73991573,73527840,123102194,3,159447916,196630034
2004,tt0299172,Home on the Range,none,ok,PASS,110000000,50026353,76482461,135651216,61692142,94317626,3,126508814,156009768
2004,tt0356721,I Heart Huckabees,none,ok,PASS,22000000,12784713,20034713,27130243,15766017,24706665,3,32819426,40472682
2004,tt0343818,"I, Robot",disagree,notalk,FAIL,105000000,144801023,348601023,129485252,178567590,429892298,3,493402046,608459888
2004,tt0385267,In Good Company,none,notalk,FAIL,26000000,45489752,63489752,32063015,56097638,78295110,3,108979504,134392748
2004,tt0362269,Kinsey,none,ok,PASS,11000000,10214647,13000959,13565122,12596630,16032690,3,23215606,28629320
2004,tt0373074,Kung Fu Hustle,disagree,nowomen,FAIL,20000000,17104669,101004669,24663858,21093356,124558238,3,118109338,145651594
2004,tt0375912,Layer Cake,none,notalk,FAIL,6500000,2339957,11850214,8015754,2885618,14613600,3,14190171,17499218
2004,tt0339291,Lemony Snicket's A Series of Unfortunate Events,none,ok,PASS,100000000,118627117,201627117,123319288,146290116,248645124,3,320254234,394935240
2004,tt0390221,Maria Full of Grace,none,ok,PASS,3200000,6529624,14441158,3946217,8052286,17808733,3,20970782,25861019
2004,tt0377092,Mean Girls,none,ok,PASS,18000000,86047227,130953026,22197472,106112827,161490339,3,217000253,267603166
2004,tt0405159,Million Dollar Baby,none,ok,PASS,30000000,100492203,232016402,36995786,123926269,286120974,3,332508605,410047243
2004,tt0349825,Miracle,none,notalk,FAIL,28000000,64378093,64474705,34529401,79390606,79509747,3,128852798,158900353
2004,tt0382189,My Summer of Love,none,ok,PASS,1700000,1000915,4951476,2096428,1234321,6106125,3,5952391,7340446
2004,tt0374900,Napoleon Dynamite,disagree,notalk,FAIL,400000,44540956,46122713,493277,54927590,56878201,3,90663669,111805791
2004,tt0363282,New York Minute,disagree,notalk,FAIL,40000000,14018364,21215882,49327715,17287347,26163275,3,35234246,43450622
2004,tt0390384,Primer,none,notalk,FAIL,7000,424760,565846,8632,523811,697797,3,990606,1221608
2004,tt0350028,Raising Helen,none,ok,PASS,50000000,37485528,43340302,61659644,46226886,53446952,3,80825830,99673838
2004,tt0350258,Ray,none,dubious,FAIL,40000000,75305995,124823094,49327715,92866817,153930950,3,200129089,246797767
2004,tt0318627,Resident Evil: Apocalypse,none,ok,PASS,50000000,50740078,128940078,61659644,62572303,159007986,3,179680156,221580289
2004,tt0332375,Saved!,disagree,ok,PASS,5000000,8886160,10228228,6165964,10958349,12613378,3,19114388,23571727
2004,tt0387564,Saw,disagree,men,FAIL,1200000,55185045,103096345,1479831,68053804,127137678,3,158281390,195191482
2004,tt0363988,Secret Window,none,notalk,FAIL,40000000,47958031,92111551,49327715,59141502,113591309,3,140069582,172732811
2004,tt0307453,Shark Tale,none,notalk,FAIL,75000000,161412000,367825111,92489466,199052129,453599307,3,529237111,652651436
2004,tt0365748,Shaun of the Dead,disagree,ok,PASS,5000000,13542874,30332385,6165964,16700976,37405681,3,43875259,54106657
2004,tt0298148,Shrek 2,disagree,ok,PASS,70000000,441226247,937008132,86323501,544117065,1155511754,3,1378234379,1699628819
2004,tt0375063,Sideways,none,ok,PASS,17000000,71502303,109874155,20964279,88176131,135496025,3,181376458,223672156
2004,tt0346156,Sky Captain and the World of Tomorrow,disagree,ok,PASS,70000000,37760080,49730854,86323501,46565462,61327735,3,87490934,107893197
2004,tt0371246,Spanglish,none,ok,PASS,75000000,42044321,54344321,92489466,51848757,67017030,3,96388642,118865787
2004,tt0316654,Spider-Man 2,disagree,notalk,FAIL,200000000,373524485,783705001,246638575,460627734,966459425,3,1157229486,1427087159
2004,tt0372588,Team America: World Police,none,men,FAIL,20000000,32774834,50274834,24663858,40417692,61998567,3,83049668,102416259
2004,tt0338751,The Aviator,none,notalk,FAIL,110000000,102608827,214608827,135651216,126536475,264654077,3,317217654,391190552
2004,tt0372183,The Bourne Supremacy,none,men,FAIL,85000000,176087450,288587450,104821395,217149789,355883988,3,464674900,573033777
2004,tt0289879,The Butterfly Effect,disagree,men,FAIL,13000000,57924679,96046844,16031507,71432302,118444284,3,153971523,189876586
2004,tt0296572,The Chronicles of Riddick,disagree,men,FAIL,120000000,57712751,107212751,147983145,71170953,132214001,3,164925502,203384954
2004,tt0319262,The Day After Tomorrow,none,ok,PASS,125000000,186740799,556319450,154149110,230287423,686049183,3,743060249,916336606
2004,tt0391198,The Grudge,none,ok,PASS,10000000,110359362,187281115,12331929,136094379,230953737,3,297640477,367048116
2004,tt0317705,The Incredibles,disagree,ok,PASS,92000000,261441092,632107545,113453745,322407292,779510522,3,893548637,1101917814
2004,tt0362270,The Life Aquatic with Steve Zissou,none,men,FAIL,50000000,24006726,34806726,61659644,29604924,42923407,3,58813452,72528331
2004,tt0332280,The Notebook,none,dubious,FAIL,30000000,81001787,102276787,36995786,99890827,126127005,3,183278574,226017832
2004,tt0293508,The Phantom of the Opera,disagree,men,FAIL,55000000,51225796,158225796,67825608,63171287,195122925,3,209451592,258294212
2004,tt0338348,The Polar Express,none,notalk,FAIL,170000000,194949659,319049659,209642789,240410531,393449767,3,513999318,633860298
2004,tt0368933,The Princess Diaries 2: Royal Engagement,none,ok,PASS,45000000,95149435,122071435,55493679,117337605,150537624,3,217220870,267875229
2004,tt0327162,The Stepford Wives,none,ok,PASS,100000000,59475623,96221971,123319288,73344915,118660249,3,155697594,192005164
2004,tt0362227,The Terminal,none,notalk,FAIL,75000000,77073959,218673959,92489466,95047057,269667169,3,295747918,364714226
2004,tt0368447,The Village,none,ok,PASS,71682975,114197520,257641634,88398934,140827568,317721828,3,371839154,458549396
2004,tt0327247,The Whole Ten Yards,none,notalk,FAIL,30000000,16323969,26323969,36995786,20130602,32462531,3,42647938,52593133
2004,tt0332452,Troy,none,notalk,FAIL,150000000,133298577,484161265,184978932,164382856,597064223,3,617459842,761447079
2004,tt0338526,Van Helsing,none,ok,PASS,170000000,120150546,300150546,209642789,148168797,370143515,3,420301092,518312312
2004,tt0383694,Vera Drake,none,ok,PASS,11000000,3753806,13353855,13565122,4629167,16467879,3,17107661,21097046
2004,tt0381707,White Chicks,none,ok,PASS,20000000,69148997,111448997,24663858,85274051,137438109,3,180597994,222712160
2004,tt0360201,Wimbledon,none,ok,PASS,35000000,16862585,41666476,43161751,20794820,51382801,3,58529061,72177621
2003,tt0322259,2 Fast 2 Furious,none,notalk,FAIL,76000000,127120058,236220058,96222609,160945047,299075134,3,363340116,460020181
2003,tt0315733,21 grams,none,dubious,FAIL,20000000,16248701,59667625,25321739,20572268,75544402,3,75916326,96116670
2003,tt0319061,Big Fish,disagree,notalk,FAIL,70000000,66432867,123432867,88626087,84109786,156276743,3,189865734,240386529
2003,tt0310778,Bon voyage,none,ok,PASS,20000000,2353728,8361736,25321739,2980024,10586685,3,10715464,13566709
2003,tt0315327,Bruce Almighty,none,ok,PASS,81000000,242704995,483473962,102553043,307285628,612120077,3,726178957,919405705
2003,tt0305357,Charlie's Angels: Full Throttle,none,ok,PASS,120000000,100814328,227200000,151930435,127639706,287654957,3,328014328,415294663
2003,tt0159365,Cold Mountain,none,ok,PASS,80000000,95632614,161632614,101286957,121079205,204640944,3,257265228,325720149
2003,tt0306685,Cradle 2 the Grave,none,notalk,FAIL,25000000,34657731,56434942,31652174,43879701,71451544,3,91092673,115331245
2003,tt0317303,Daddy Day Care,none,ok,PASS,60000000,104148781,164285587,75965217,131861413,207999839,3,268434368,339861252
2003,tt0287978,Daredevil,disagree,nowomen,FAIL,80000000,102543518,182782518,101286957,129829011,231418562,3,285326036,361247573
2003,tt0282209,Darkness Falls,none,notalk,FAIL,7000000,32539681,32539681,8862609,41198066,41198066,3,65079362,82396132
2003,tt0285531,Dreamcatcher,none,nowomen,FAIL,68000000,33685268,75685268,86093913,42648478,95824131,3,109370536,138472609
2003,tt0309593,Final Destination 2,none,ok,PASS,26000000,46896664,90396664,32918261,59375255,114450037,3,137293328,173825292
2003,tt0266543,Finding Nemo,disagree,notalk,FAIL,94000000,380529370,906465556,119012174,481783272,1147664217,3,1286994926,1629447489
2003,tt0322330,Freaky Friday,none,ok,PASS,26000000,110222438,160822438,32918261,139551191,203615191,3,271044876,343166382
2003,tt0335119,Girl with a Pearl Earring,none,ok,PASS,12000000,11634362,43281552,15193043,14730114,54798208,3,54915914,69528322
2003,tt0301357,Goodbye Lenin!,disagree,ok,PASS,6400000,4063859,79384539,8102957,5145199,100507729,3,83448398,105652928
2003,tt0311289,Holes,disagree,men,FAIL,20000000,67383924,72383924,25321739,85313907,91644342,3,139767848,176958249
2003,tt0329717,Hollywood Homicide,none,notalk,FAIL,75000000,30207785,51107785,94956522,38245683,64706900,3,81315570,102952583
2003,tt0315983,House of Sand and Fog,none,ok,PASS,16500000,13005485,16157923,20890435,16466075,20457336,3,29163408,36923411
2003,tt0251127,How to Lose a Guy in 10 Days,disagree,men,FAIL,50000000,105807520,177079973,63304348,133961521,224198644,3,282887493,358160165
2003,tt0286716,Hulk,none,notalk,FAIL,137000000,132177234,245229234,173453913,167347872,310481535,3,377406468,477829407
2003,tt0309698,Identity,none,notalk,FAIL,28000000,52131264,82183683,35450435,66002713,104051689,3,134314947,170054402
2003,tt0199626,In the Cut,none,ok,PASS,12000000,4717455,23693646,15193043,5972708,29998216,3,28411101,35970924
2003,tt0301470,Jeepers Creepers II,none,ok,PASS,25000000,35623801,35623801,31652174,45102830,45102830,3,71247602,90205660
2003,tt0266697,Kill Bill: Vol. 1,disagree,ok,PASS,55000000,70098138,180098138,69634783,88750338,228019903,3,250196276,316770241
2003,tt0325703,Lara Croft Tomb Raider: The Cradle of Life,disagree,nowomen,FAIL,90000000,65653758,156453758,113947826,83123367,198084062,3,222107516,281207429
2003,tt0333780,"Legally Blonde 2: Red, White & Blonde",none,ok,PASS,25000000,90639088,125339088,31652174,114756967,158690184,3,215978176,273447151
2003,tt0286244,Les triplettes de Belleville,none,ok,PASS,2000000,7301288,14440113,2532174,9244066,18282439,3,21741401,27526505
2003,tt0335266,Lost In Translation,disagree,dubious,FAIL,4000000,44585453,112550685,5064348,56449060,142498954,3,157136138,198948014
2003,tt0314331,Love Actually,disagree,ok,PASS,45000000,59472278,247967903,56973913,75297075,313948928,3,307440181,389246003
2003,tt0311113,Master and Commander: The Far Side of the World,none,nowomen,FAIL,135000000,93926386,212912137,170921739,118918972,269565280,3,306838523,388484252
2003,tt0304415,Mona Lisa Smile,none,ok,PASS,65000000,63803100,141205169,82295652,80780273,178778023,3,205008269,259558296
2003,tt0340855,Monster,none,ok,PASS,5000000,34469210,58003694,6330435,43641017,73437720,3,92472904,117078737
2003,tt0327056,Mystic River,none,ok,PASS,30000000,90135191,156835191,37982609,114118990,198566990,3,246970382,312685980
2003,tt0316396,Peter Pan,none,ok,PASS,100000000,48417850,95255485,126608696,61301208,120601727,3,143673335,181902935
2003,tt0325980,Pirates of the Caribbean: The Curse of the Black Pearl,disagree,men,FAIL,125000000,305411224,634954103,158260870,386677167,803907108,3,940365327,1190584275
2003,tt0366920,Pride and Prejudice,none,ok,PASS,28000000,38372662,120918508,35450435,48583127,153093346,3,159291170,201676473
2003,tt0257076,S.W.A.T.,none,ok,PASS,70000000,116877597,207154748,88626087,147977201,262275924,3,324032345,410253125
2003,tt0306047,Scary Movie 3,none,ok,PASS,45000000,110000082,155200000,56973913,139269669,196496696,3,265200082,335766365
2003,tt0327137,Secondhand Lions,none,notalk,FAIL,30000000,42070939,47902566,37982609,53265467,60648814,3,89973505,113914281
2003,tt0300471,Shanghai Knights,none,notalk,FAIL,50000000,60470220,88316835,63304348,76560557,111816793,3,148787055,188377350
2003,tt0323944,Shattered Glass,none,men,FAIL,6000000,2207975,2932719,7596522,2795488,3713077,3,5140694,6508565
2003,tt0165982,Sinbad: Legend of the Seven Seas,none,men,FAIL,60000000,26483452,80767884,75965217,33530353,102259164,3,107251336,135789517
2003,tt0337741,Something's Gotta Give,none,dubious,FAIL,80000000,124685242,266685242,101286957,157862359,337646706,3,391370484,495509065
2003,tt0338459,Spy Kids 3-D: Game Over,none,ok,PASS,40000000,111760631,167851995,50643478,141498677,212515222,3,279612626,354013899
2003,tt0324133,Swimming Pool,none,ok,PASS,7800000,10130108,22441323,9875478,12825598,28412666,3,32571431,41238264
2003,tt0181852,Terminator 3: Rise of the Machines,none,ok,PASS,170000000,150358296,433058296,215234783,190366677,548289460,3,583416592,738656137
2003,tt0298814,The Core,none,ok,PASS,85000000,31111260,74132631,107617391,39389560,93858357,3,105243891,133247917
2003,tt0317740,The Italian Job,disagree,notalk,FAIL,60000000,106126012,176262839,75965217,134364760,223164081,3,282388851,357528841
2003,tt0283426,The Jungle Book 2,disagree,nowomen,FAIL,20000000,47901582,135703599,25321739,60647568,171812557,3,183605181,232460125
2003,tt0325710,The Last Samurai,none,nowomen,FAIL,140000000,111110575,456810575,177252174,140675650,578361911,3,567921150,719037561
2003,tt0311429,The League of Extraordinary Gentlemen,none,nowomen,FAIL,78000000,66465204,179265204,98754783,84150728,226965337,3,245730408,311116065
2003,tt0167260,The Lord of the Rings: The Return of the King,none,notalk,FAIL,94000000,377845905,1141408667,119012174,478385772,1445122625,3,1519254572,1923508397
2003,tt0234215,The Matrix Reloaded,disagree,ok,PASS,127000000,281553689,738576929,160793043,356471453,935102616,3,1020130618,1291574069
2003,tt0242653,The Matrix Revolutions,disagree,ok,PASS,110000000,139259759,424259759,139269565,176314964,537149747,3,563519518,713464711
2003,tt0338188,The Missing,none,ok,PASS,65000000,26900336,38253433,82295652,34058165,48432173,3,65153769,82490338
2003,tt0332379,The School of Rock,none,dubious,FAIL,20000000,81261177,131161177,25321739,102883716,166061455,3,212422354,268945171
2003,tt0328538,Thirteen,none,ok,PASS,2000000,4601043,9505996,2532174,5825321,12035418,3,14107039,17860739
2003,tt0300556,Timeline,none,notalk,FAIL,80000000,19480739,26703184,101286957,24664310,33808553,3,46183923,58472863
2003,tt0339840,Undead,none,ok,PASS,750000,41196,229250,949565,52158,290250,3,270446,342408
2003,tt0320691,Underworld,none,dubious,FAIL,22000000,51970690,95708457,27853913,65799413,121175229,3,147679147,186974642
2003,tt0295700,Wrong Turn,none,ok,PASS,10000000,15417771,28649556,12660870,19520239,36272829,3,44067327,55793068
2003,tt0290334,X2 (X-Men 2),disagree,ok,PASS,125000000,214949694,407711549,158260870,272145004,516198274,3,622661243,788343278
2002,tt0307901,25th Hour,none,men,FAIL,4500000,13084595,25344490,5828306,16946895,32825657,3,38429085,49772552
2002,tt0289043,28 Days Later...,none,ok,PASS,8000000,45064915,82955633,10361434,58367141,107442412,3,128020548,165809553
2002,tt0283832,8 femmes,disagree,ok,PASS,8000000,3076425,42376425,10361434,3984522,54885065,3,45452850,58869587
2002,tt0298203,8 Mile,none,notalk,FAIL,41000000,116724075,242924075,53102348,151178596,314630213,3,359648150,465808809
2002,tt0257360,About Schmidt,none,notalk,FAIL,30000000,65005217,105823486,38855376,84193406,137060380,3,170828703,221253786
2002,tt0268126,Adaptation,none,dubious,FAIL,18500000,22498520,22498520,23960815,29139615,29139615,3,44997040,58279230
2002,tt0286261,All or Nothing,none,ok,PASS,9000000,184255,184255,11656613,238643,238643,3,368510,477286
2002,tt0168786,Antwone Fisher,none,notalk,FAIL,12500000,21078145,23367586,16189740,27299975,30265212,3,44445731,57565187
2002,tt0295178,Austin Powers in Goldmember,none,notalk,FAIL,63000000,213117789,292738626,81596291,276025731,379148984,3,505856415,655174715
2002,tt0286499,Bend It Like Beckham,none,ok,PASS,5600000,32543449,76730377,7253004,42149599,99379590,3,109273826,141529189
2002,tt0187738,Blade II,none,notalk,FAIL,54000000,81676888,154338601,69939678,105786208,199896148,3,236015489,305682356
2002,tt0300532,Blue Crush,none,ok,PASS,30000000,40118420,51618420,38855376,51960544,66855105,3,91736840,118815649
2002,tt0303816,Cabin Fever,none,ok,PASS,1500000,21158188,30351664,1942769,27403645,39310844,3,51509852,66714489
2002,tt0319970,Carrie,none,ok,PASS,30000000,35266619,85001659,38855376,45676592,110092382,3,120268278,155768974
2002,tt0264464,Catch Me If You Can,disagree,notalk,FAIL,52000000,164606800,351106800,67349319,213195306,454746230,3,515713600,667941536
2002,tt0299658,Chicago,none,ok,PASS,30000000,170687518,307687518,38855376,221070926,398510478,3,478375036,619581404
2002,tt0275022,Crossroads,none,ok,PASS,12000000,37188667,57000000,15542151,48165989,73825215,3,94188667,121991204
2002,tt0266452,Death to Smoochy,none,men,FAIL,50000000,8355815,8374062,64758961,10822278,10845911,3,16729877,21668189
2002,tt0246460,Die Another Day,disagree,men,FAIL,142000000,160942139,431942139,183915449,208448913,559442481,3,592884278,767891394
2002,tt0303933,Drumline,none,notalk,FAIL,20000000,56398162,56398162,25903584,73045727,73045727,3,112796324,146091454
2002,tt0238380,Equilibrium,none,notalk,FAIL,20000000,1190018,5345869,25903584,1541287,6923858,3,6535887,8465145
2002,tt0297884,Far from Heaven,none,ok,PASS,13500000,15901849,29027914,17484919,20595744,37596351,3,44929763,58192095
2002,tt0120679,Frida,disagree,men,FAIL,12000000,25885000,55710675,15542151,33525714,72155308,3,81595675,105681022
2002,tt0327753,Funny Ha Ha,none,ok,PASS,30000,77070,77070,38855,99819,99819,3,154140,199638
2002,tt0217505,Gangs of New York,none,notalk,FAIL,97000000,77730500,190400000,125632384,100674928,246602123,3,268130500,347277051
2002,tt0302674,Gerry,none,nowomen,FAIL,7000000,254683,254683,9066255,329860,329860,3,509366,659720
2002,tt0295297,Harry Potter and the Chamber of Secrets,disagree,ok,PASS,100000000,261987880,878979634,129517922,339321257,1138436153,3,1140967514,1477757410
2002,tt0257756,High Crimes,none,ok,PASS,42000000,41543207,63781100,54397527,53805898,82607955,3,105324307,136413853
2002,tt0297181,I Spy,none,notalk,FAIL,70000000,33561137,60279822,90662545,43467687,78073173,3,93840959,121540860
2002,tt0268380,Ice Age,none,nowomen,FAIL,65000000,176387405,386116343,84186649,228453301,500089862,3,562503748,728543163
2002,tt0280760,Igby Goes Down,none,men,FAIL,9000000,4777465,4777465,11656613,6187673,6187673,3,9554930,12375346
2002,tt0278504,Insomnia,none,notalk,FAIL,46000000,67263182,113622499,59578244,87117875,147161499,3,180885681,234279374
2002,tt0275847,Lilo and Stitch,disagree,ok,PASS,80000000,145771527,245800000,103614337,188800252,318355051,3,391571527,507155303
2002,tt0252076,Maid in Manhattan,none,ok,PASS,55000000,93932896,163838217,71234857,121659935,212199853,3,257771113,333859788
2002,tt0303361,May,none,ok,PASS,1750000,145540,497339,2266564,188500,644143,3,642879,832643
2002,tt0120912,Men in Black II,none,notalk,FAIL,140000000,190418803,441767803,181325090,246626476,572168477,3,632186606,818794953
2002,tt0181689,Minority Report,disagree,notalk,FAIL,102000000,132024714,358824714,132108280,170995666,464742312,3,490849428,635737978
2002,tt0280590,Mr Deeds,none,men,FAIL,50000000,126293452,171269535,64758961,163572654,221824742,3,297562987,385397396
2002,tt0259446,My Big Fat Greek Wedding,none,ok,PASS,5000000,241438208,352242522,6475896,312705749,456217193,3,593680730,768922942
2002,tt0258000,Panic Room,none,ok,PASS,48000000,95308367,196308367,62168602,123441416,254254517,3,291616734,377695933
2002,tt0183649,Phone Booth,none,notalk,FAIL,11000000,46566212,97837138,14246971,60311590,126716628,3,144403350,187028218
2002,tt0238546,Queen of the Damned,none,ok,PASS,35000000,30307804,30307804,45331273,39254038,39254038,3,60615608,78508076
2002,tt0252444,Rabbit-Proof Fence,none,ok,PASS,7000000,6199600,16866928,9066255,8029593,21845695,3,23066528,29875288
2002,tt0296166,Real Women Have Curves,none,ok,PASS,3000000,5853194,5853194,3885538,7580935,7580935,3,11706388,15161870
2002,tt0289765,Red Dragon,none,notalk,FAIL,78000000,92955420,206455420,101023979,120393928,267396769,3,299410840,387790697
2002,tt0253556,Reign of Fire,none,notalk,FAIL,60000000,43061982,82150183,77710753,55772984,106399210,3,125212165,162172194
2002,tt0120804,Resident Evil,none,ok,PASS,35000000,40119709,103787401,45331273,51962213,134423285,3,143907110,186385498
2002,tt0267913,Scooby-Doo,none,ok,PASS,84000000,153294164,276294164,108795054,198543415,357850459,3,429588328,556393874
2002,tt0286106,Signs,none,notalk,FAIL,70702619,227965690,408265690,91572563,295256424,528777236,3,636231380,824033660
2002,tt0281373,Snow Dogs,none,notalk,FAIL,32000000,81150692,116898028,41445735,105104690,151403896,3,198048720,256508586
2002,tt0307479,Solaris,none,notalk,FAIL,47000000,14970038,14970038,60873423,19388882,19388882,3,29940076,38777764
2002,tt0145487,Spider-Man,none,notalk,FAIL,139000000,403706375,821565375,180029911,522872106,1064074398,3,1225271750,1586946504
2002,tt0166813,Spirit: Stallion of the Cimarron,disagree,nowomen,FAIL,80000000,73215310,106515310,103614337,94826948,137956416,3,179730620,232783364
2002,tt0283003,Spun,none,ok,PASS,4500000,410241,1022649,5828306,531336,1324514,3,1432890,1855850
2002,tt0287717,Spy Kids 2: Island of Lost Dreams,none,ok,PASS,38000000,85846296,119721296,49216810,111186338,155060534,3,205567592,266246872
2002,tt0253754,Star Trek: Nemesis,none,notalk,FAIL,60000000,43254409,67312826,77710753,56022212,87182173,3,110567235,143204385
2002,tt0121765,Star Wars: Episode II - Attack of the Clones,disagree,dubious,FAIL,115000000,310676740,656695615,148945610,402382056,850538512,3,967372355,1252920568
2002,tt0180052,The Adventures of Pluto Nash,none,men,FAIL,100000000,4411102,7094995,129517922,5713168,9189290,3,11506097,14902458
2002,tt0280460,The Banger Sisters,none,ok,PASS,10000000,30306281,38067218,12951792,39252065,49303870,3,68373499,88555935
2002,tt0258463,The Bourne Identity,none,notalk,FAIL,60000000,121468960,213300000,77710753,157324072,276261727,3,334768960,433585799
2002,tt0238924,The Dangerous Lives of Altar Boys,none,notalk,FAIL,12000000,1779284,1779284,15542151,2304492,2304492,3,3558568,4608984
2002,tt0279113,The Good Girl,none,ok,PASS,8000000,14018296,16856124,10361434,18156206,21831701,3,30874420,39987907
2002,tt0274558,The Hours,none,ok,PASS,25000000,41675994,97030468,32379480,53977881,125671845,3,138706462,179649726
2002,tt0278500,The Importance of Being Earnest,none,ok,PASS,15000000,8378141,8378141,19427688,10851194,10851194,3,16756282,21702388
2002,tt0167261,The Lord of the Rings: The Two Towers,disagree,notalk,FAIL,94000000,342548984,927048984,121746846,443662324,1200694576,3,1269597968,1644356900
2002,tt0289408,The Powerpuff Girls,none,ok,PASS,25000000,11411644,16425701,32379480,14780124,21274227,3,27837345,36054351
2002,tt0258068,The Quiet American,none,men,FAIL,20000000,12987647,26348203,25903584,16821330,34125645,3,39335850,50946975
2002,tt0298130,The Ring,none,ok,PASS,48000000,129094024,248218486,62168602,167199897,321487424,3,377312510,488687321
2002,tt0292644,The Rules of Attraction,none,dubious,FAIL,4000000,6525762,11799060,5180717,8452031,15281897,3,18324822,23733928
2002,tt0304669,The Santa Clause 2,none,notalk,FAIL,65000000,139225854,172825854,84186649,180322432,223840454,3,312051708,404162886
2002,tt0253867,The Sweetest Thing,none,ok,PASS,43000000,24430272,44633441,55692706,31641581,57808305,3,69063713,89449886
2002,tt0293662,The Transporter,none,nowomen,FAIL,21000000,25296447,43928932,27198764,32763432,56895840,3,69225379,89659272
2002,tt0290095,The Tuxedo,none,nowomen,FAIL,60000000,50586000,104429625,77710753,65517936,135255080,3,155015625,200773016
2002,tt0133240,Treasure Planet,none,notalk,FAIL,100000000,38120554,91800000,129517922,49372949,118897452,3,129920554,168270401
2002,tt0283084,Tuck Everlasting,none,ok,PASS,15000000,19161999,19344615,19427688,24818223,25054743,3,38506614,49872966
2002,tt0313737,Two Weeks Notice,none,ok,PASS,60000000,93354918,199043309,77710753,120911349,257796757,3,292398227,378708106
2002,tt0277434,We Were Soldiers,none,ok,PASS,70000000,78120196,114658262,90662545,101179654,148502998,3,192778458,249682652
2002,tt0298228,Whale Rider,none,ok,PASS,4300000,20779666,39892476,5569271,26913392,51667906,3,60672142,78581298
2002,tt0283139,White Oleander,none,ok,PASS,16000000,16357770,21657770,20722867,21186244,28050694,3,38015540,49236938
2002,tt0295701,xXx,none,notalk,FAIL,70000000,141930000,267200000,90662545,183824786,346071886,3,409130000,529896672
2001,tt0268978,A Beautiful Mind,none,notalk,FAIL,78000000,170708996,317668058,102635985,224626742,418002230,3,488377054,642628972
2001,tt0183790,A Knight's Tale,none,men,FAIL,41000000,56083966,100622586,53949684,73797860,132403823,3,156706552,206201683
2001,tt0164334,Along Came A Spider,none,ok,PASS,28000000,74058698,105159085,36843687,97449838,138373157,3,179217783,235822995
2001,tt0244000,American Outlaws,none,notalk,FAIL,35000000,13264986,13264986,46054609,17454678,17454678,3,26529972,34909356
2001,tt0218817,Antitrust,none,men,FAIL,30000000,10965209,17865209,39475379,14428526,23507863,3,28830418,37936389
2001,tt0212720,Artificial Intelligence: AI,none,notalk,FAIL,90000000,78616689,235900000,118426136,103447452,310408061,3,314516689,413855513
2001,tt0230011,Atlantis: The Lost Empire,disagree,notalk,FAIL,90000000,84052762,186049020,118426136,110600487,244811851,3,270101782,355412338
2001,tt0265086,Black Hawk Down,disagree,nowomen,FAIL,95000000,108638745,159691085,125005366,142951853,210128869,3,268329830,353080722
2001,tt0221027,Blow,none,notalk,FAIL,30000000,52990775,83282296,39475379,69727697,109586673,3,136273071,179314370
2001,tt0243155,Bridget Jones's Diary,none,ok,PASS,25000000,71500556,281527158,32896149,94083718,370446373,3,353027714,464530091
2001,tt0260866,Don't Say A Word,none,ok,PASS,50000000,54997476,104488383,65792298,72368206,137490616,3,159485859,209858822
2001,tt0246578,Donnie Darko,disagree,dubious,FAIL,4500000,1270522,7696529,5921307,1671811,10127447,3,8967051,11799258
2001,tt0240462,Dr. Dolittle 2,none,ok,PASS,72000000,112950721,176101721,94740909,148625750,231722738,3,289052442,380348488
2001,tt0251075,Evolution,none,ok,PASS,80000000,38311134,98341932,105267677,50411551,129402834,3,136653066,179814385
2001,tt0120681,From Hell,none,dubious,FAIL,35000000,31598308,68712365,46054609,41578506,90414888,3,100310673,131993394
2001,tt0162346,Ghost World,none,ok,PASS,5500000,6217849,8761608,7237153,8181731,11528926,3,14979457,19710657
2001,tt0280707,Gosford Park,none,ok,PASS,18000000,41300105,41300105,23685227,54344576,54344576,3,82600210,108689152
2001,tt0212985,Hannibal,none,ok,PASS,87000000,165092266,350100280,114478598,217235991,460678038,3,515192546,677914029
2001,tt0241527,Harry Potter and the Sorcerer's Stone,none,ok,PASS,125000000,317575550,974755371,164480745,417880504,1282627914,3,1292330921,1700508418
2001,tt0248845,Hedwig and the Angry Inch,disagree,ok,PASS,6000000,3067312,3643900,7895076,4036110,4794811,3,6711212,8830921
2001,tt0253126,High Heels and Low Lifes,none,ok,PASS,10000000,226792,226792,13158460,298423,298423,3,453584,596846
2001,tt0160399,Impostor,none,nowomen,FAIL,40000000,6114237,6114237,52633838,8045394,8045394,3,12228474,16090788
2001,tt0211443,Jason X,none,ok,PASS,14000000,13121555,16951798,18421843,17265945,22305955,3,30073353,39571900
2001,tt0261392,Jay and Silent Bob Strike Back,none,ok,PASS,22000000,30059386,33762400,28948611,39553522,44426118,3,63821786,83979640
2001,tt0263488,Jeepers Creepers,none,ok,PASS,10000000,37904175,58939035,13158460,49876055,77554691,3,96843210,127430746
2001,tt0236348,Josie and the Pussycats,none,ok,PASS,22000000,14252830,14252830,28948611,18754529,18754529,3,28505660,37509058
2001,tt0035423,Kate & Leopold,disagree,men,FAIL,48000000,47095453,70937778,63160606,61970361,93343188,3,118033231,155313549
2001,tt0271027,Kiss of the Dragon,none,notalk,FAIL,25000000,36833473,36833473,32896149,48467177,48467177,3,73666946,96934354
2001,tt0264761,Kissing Jessica Stein,none,ok,PASS,1500000,7025722,8831884,1973769,9244768,11621399,3,15857606,20866167
2001,tt0242587,L.I.E.,none,notalk,FAIL,700000,1140965,1140965,921092,1501334,1501334,3,2281930,3002668
2001,tt0146316,Lara Croft: Tomb Raider,none,nowomen,FAIL,94000000,131144183,274644183,123689520,172565543,361389438,3,405788366,533954981
2001,tt0250494,Legally Blonde,none,ok,PASS,18000000,96493426,141809235,23685227,126970485,186599109,3,238302661,313569594
2001,tt0258273,Lovely and Amazing,none,ok,PASS,250000,4210379,4695781,328961,5540210,6178924,3,8906160,11719134
2001,tt0166276,Monkeybone,disagree,dubious,FAIL,75000000,5409517,5409517,98688447,7118091,7118091,3,10819034,14236182
2001,tt0265343,Monsoon Wedding,none,ok,PASS,1200000,13876974,27025600,1579015,18259960,35561527,3,40902574,53821487
2001,tt0198781,"Monsters, Inc.",disagree,notalk,FAIL,115000000,289423425,559757719,151322285,380836644,736554932,3,849181144,1117391576
2001,tt0203009,Moulin Rouge!,none,ok,PASS,53000000,57386369,179213196,69739836,75511622,235816959,3,236599565,311328581
2001,tt0166924,Mulholland Dr.,none,ok,PASS,15000000,7219578,11919578,19737689,9499853,15684329,3,19139156,25184182
2001,tt0161860,Nowhere in Africa,none,ok,PASS,6500000,6173485,6173485,8552999,8123355,8123355,3,12346970,16246710
2001,tt0240772,Ocean's Eleven,none,notalk,FAIL,85000000,183417150,450728529,111846906,241348715,593089313,3,634145679,834438028
2001,tt0181739,Osmosis Jones,none,dubious,FAIL,70000000,13596911,13596911,92109217,17891440,17891440,3,27193822,35782880
2001,tt0213149,Pearl Harbor,disagree,men,FAIL,151500000,198539855,449239855,199350663,261247866,591130447,3,647779710,852378313
2001,tt0206275,Save the Last Dance,none,ok,PASS,13000000,91038276,131638276,17105997,119792347,173215693,3,222676552,293008040
2001,tt0256380,Shallow Hal,none,ok,PASS,40000000,70836296,70836296,52633838,93209654,93209654,3,141672592,186419308
2001,tt0286112,Shaolin Soccer,none,nowomen,FAIL,10000000,488872,42776032,13158460,643280,56286669,3,43264904,56929949
2001,tt0126029,Shrek,disagree,notalk,FAIL,50000000,267655011,491812794,65792298,352192764,647149877,3,759467805,999342641
2001,tt0244970,Someone Like You...,none,ok,PASS,23000000,27338033,38684906,30264457,35972640,50903377,3,66022939,86876017
2001,tt0227538,Spy Kids,none,ok,PASS,35000000,112692062,197692062,46054609,148285394,260132301,3,310384124,408417695
2001,tt0247745,Super Troopers,none,notalk,FAIL,3000000,18492362,23046142,3947538,24333100,30325173,3,41538504,54658273
2001,tt0232500,The Fast and the Furious,none,notalk,FAIL,38000000,144512310,206512310,50002146,190155939,271738388,3,351024620,461894327
2001,tt0221218,The Glass House,none,ok,PASS,22000000,17951431,22861785,28948611,23621318,30082587,3,40813216,53703905
2001,tt0290879,The Legend of Suriyothai,none,ok,PASS,9000000,454255,454255,11842614,597730,597730,3,908510,1195460
2001,tt0120737,The Lord of the Rings: The Fellowship of the Ring,disagree,notalk,FAIL,109000000,315544750,887217688,143427209,415208284,1167441808,3,1202762438,1582650092
2001,tt0268995,The Majestic,none,notalk,FAIL,72000000,27796042,37306334,94740909,36575310,49089389,3,65102376,85664699
2001,tt0267804,The One,none,nowomen,FAIL,49000000,43905746,43905746,64476452,57773198,57773198,3,87811492,115546396
2001,tt0230600,The Others,none,ok,PASS,17000000,96522687,209947037,22369381,127008987,276257960,3,306469724,403266947
2001,tt0247638,The Princess Diaries,none,ok,PASS,30000000,108244774,165334774,39475379,142433448,217555094,3,273579548,359988542
2001,tt0265666,The Royal Tenenbaums,none,ok,PASS,28000000,52353636,71430876,36843687,68889320,93992029,3,123784512,162881349
2001,tt0209475,The Wedding Planner,none,ok,PASS,28000000,60400856,94728529,36843687,79478222,124648152,3,155129385,204126374
2001,tt0245674,Thir13en Ghosts,none,notalk,FAIL,19000000,41867960,68467960,25001073,55091786,90093288,3,110335920,145185074
2001,tt0139654,Training Day,none,notalk,FAIL,45000000,76261036,104505362,59213068,100347776,137512958,3,180766398,237860734
2001,tt0242998,Valentine,none,men,FAIL,10000000,20384136,20384136,13158460,26822383,26822383,3,40768272,53644766
2001,tt0259711,Vanilla Sky,none,notalk,FAIL,70000000,100614858,202726605,92109217,132393654,266756984,3,303341463,399150638
2001,tt0196229,Zoolander,disagree,ok,PASS,28000000,45172250,60780981,36843687,59439723,79978408,3,105953231,139418131
2000,tt0191754,28 Days,none,ok,PASS,43000000,37035515,62063972,58175060,50105659,83966868,3,99099487,134072527
2000,tt0181875,Almost Famous,none,ok,PASS,60000000,32522352,47371191,81174503,43999763,64088881,3,79893543,108088644
2000,tt0144084,American Psycho,disagree,notalk,FAIL,8000000,15070285,28674417,10823267,20388715,38793859,3,43744702,59182574
2000,tt0221889,Beautiful Creatures,none,ok,PASS,50000000,19452138,55940671,67645419,26316961,75682603,3,75392809,101999564
2000,tt0218839,Best in Show,none,ok,PASS,6000000,18621249,20695413,8117450,25192844,27998998,3,39316662,53191842
2000,tt0249462,Billy Elliot,none,ok,PASS,5000000,21995263,109280263,6764542,29757576,147846184,3,131275526,177603760
2000,tt0181984,Boiler Room,none,notalk,FAIL,9000000,16963963,28773637,12176175,22950688,38928095,3,45737600,61878783
2000,tt0204946,Bring It On,none,ok,PASS,10000000,68353550,90453550,13529084,92476091,122375366,3,158807100,214851457
2000,tt0162222,Cast Away,none,notalk,FAIL,85000000,233632142,427230516,114997212,316082883,578003746,3,660862658,894086629
2000,tt0173716,Cecil B. Demented,none,ok,PASS,10000000,1276984,1953882,13529084,1727642,2643423,3,3230866,4371065
2000,tt0210616,Center Stage,none,ok,PASS,18000000,17200925,17200925,24352351,23271276,23271276,3,34401850,46542552
2000,tt0160127,Charlie's Angels,none,ok,PASS,90000000,125305545,259736090,121761754,169526922,351399133,3,385041635,520926055
2000,tt0120630,Chicken Run,none,ok,PASS,42000000,106793915,227793915,56822152,144482383,308184297,3,334587830,452666680
2000,tt0241303,Chocolat,none,ok,PASS,25000000,71309760,152500343,33822710,96475572,206318992,3,223810103,302794564
2000,tt0200550,Coyote Ugly,disagree,men,FAIL,45000000,60786269,115786269,60880877,82238253,156648214,3,176572538,238886467
2000,tt0168629,Dancer in the Dark,none,ok,PASS,12500000,4157491,45557491,16911355,5624704,61635111,3,49714982,67259815
2000,tt0242423,"Dude, Where's My Car",none,men,FAIL,14000000,46729374,73180297,18940717,63220562,99006237,3,119909671,162226799
2000,tt0142032,Dune,none,ok,PASS,45000000,27447471,27447471,60880877,37133914,37133914,3,54894942,74267828
2000,tt0195685,Erin Brockovich,none,ok,PASS,50000000,125548685,257805243,67645419,169855868,348786874,3,383353928,518642742
2000,tt0195714,Final Destination,none,notalk,FAIL,23000000,53302314,112036870,31116893,72113147,151575620,3,165339184,223688767
2000,tt0172495,Gladiator,none,nowomen,FAIL,103000000,187683805,457683805,139349563,253918993,619204256,3,645367610,873123249
2000,tt0187078,Gone in Sixty Seconds,none,notalk,FAIL,103300000,101643008,232643008,139755436,137513677,314744675,3,334286016,452258352
2000,tt0146882,High Fidelity,none,men,FAIL,20000000,27277055,47881663,27058168,36903356,64779503,3,75158718,101682859
2000,tt0164052,Hollow Man,none,ok,PASS,90000000,73209340,191200000,121761754,99045530,258676083,3,264409340,357721613
2000,tt0185431,Little Nicky,none,notalk,FAIL,80000000,39442871,58270391,108232671,53362591,78834500,3,97713262,132197091
2000,tt0199725,Love & Basketball,none,ok,PASS,15000000,27441122,27709625,20293626,37125324,37488584,3,55150747,74613908
2000,tt0212338,Meet the Parents,none,men,FAIL,55000000,166225040,304599899,74409961,224887250,412095756,3,470824939,636983006
2000,tt0209144,Memento,none,notalk,FAIL,5000000,25544867,39723096,6764542,34559865,53741710,3,65267963,88301575
2000,tt0212346,Miss Congeniality,none,ok,PASS,45000000,106807667,213420951,60880877,144500988,288738993,3,320228618,433239981
2000,tt0183523,Mission to Mars,none,notalk,FAIL,90000000,60874615,106000000,121761754,82357777,143408288,3,166874615,225766065
2000,tt0190590,"O Brother, Where Art Thou?",disagree,nowomen,FAIL,26000000,45506619,75763814,35175618,61566286,102501499,3,121270433,164067785
2000,tt0134847,Pitch Black,none,ok,PASS,23000000,39235088,53182088,31116893,53081479,71950493,3,92417176,125031972
2000,tt0257001,Pokemon: The Movie 2000,none,men,FAIL,30000000,43746923,133946923,40587251,59185579,181217915,3,177693846,240403494
2000,tt0199753,Red Planet,none,nowomen,FAIL,80000000,17480890,33463969,108232671,23650043,45273684,3,50944859,68923727
2000,tt0210945,Remember the Titans,disagree,notalk,FAIL,30000000,115654751,136706683,40587251,156470282,184951617,3,252361434,341421899
2000,tt0180093,Requiem for a Dream,none,ok,PASS,4500000,3635482,7390108,6088088,4918474,9998139,3,11025590,14916613
2000,tt0122459,Return to Me,disagree,dubious,FAIL,24000000,32662299,32662299,32469801,44189098,44189098,3,65324598,88378196
2000,tt0165929,Romeo Must Die,none,nowomen,FAIL,25000000,55973336,91036760,33822710,75726795,123164396,3,147010096,198891191
2000,tt0213203,Rugrats in Paris:,none,ok,PASS,30000000,76501438,103284813,40587251,103499437,139734889,3,179786251,243234326
2000,tt0195234,Saving Grace,none,ok,PASS,4000000,12178602,27786849,5411634,16476533,37593061,3,39965451,54069594
2000,tt0134084,Scream 3,none,ok,PASS,40000000,89138076,161838076,54116335,120595650,218952089,3,250976152,339547739
2000,tt0203119,Sexy Beast,none,men,FAIL,4300000,6946056,10154577,5817506,9397377,13738212,3,17100633,23135589
2000,tt0184894,Shanghai Noon,disagree,notalk,FAIL,55000000,56932305,71189835,74409961,77024193,96313324,3,128122140,173337517
2000,tt0208092,Snatch.,disagree,nowomen,FAIL,10000000,30093107,83593107,13529084,40713217,113093815,3,113686214,153807032
2000,tt0210299,Songcatcher,none,ok,PASS,1800000,3050934,3050934,2435235,4127634,4127634,3,6101868,8255268
2000,tt0163978,The Beach,none,notalk,FAIL,50000000,39778599,39778599,67645419,53816800,53816800,3,79557198,107633600
2000,tt0209958,The Cell,none,men,FAIL,35000000,61280963,85911226,47351793,82907528,116230018,3,147192189,199137546
2000,tt0120917,The Emperor's New Groove,disagree,ok,PASS,100000000,89296573,169296573,135290838,120810082,229042753,3,258593146,349852835
2000,tt0219699,The Gift,none,dubious,FAIL,10000000,12008642,44567606,13529084,16246592,60295888,3,56576248,76542480
2000,tt0187393,The Patriot,none,dubious,FAIL,110000000,113330342,215300000,148819922,153325570,291281175,3,328630342,444606745
2000,tt0138749,The Road to El Dorado,none,nowomen,FAIL,95000000,50802661,65700000,128526296,68731346,88886081,3,116502661,157617427
2000,tt0202677,The Way of the Gun,none,men,FAIL,9000000,6047856,13061935,12176175,8182195,17671601,3,19109791,25853796
2000,tt0190138,The Whole Nine Yards,none,ok,PASS,24000000,57262492,85527867,32469801,77470905,115711368,3,142790359,193182273
2000,tt0146309,Thirteen days,none,notalk,FAIL,80000000,34566746,66554547,108232671,46765640,90042204,3,101121293,136807844
2000,tt0120913,Titan A.E.,none,ok,PASS,75000000,22751979,36751979,101468129,30781343,49722060,3,59503958,80503403
2000,tt0217869,Unbreakable,disagree,nowomen,FAIL,73243106,94999143,248099143,99091212,128525137,335655410,3,343098286,464180547
2000,tt0182508,Urbania,none,notalk,FAIL,225000,1032075,1032075,304404,1396303,1396303,3,2064150,2792606
2000,tt0190865,Vertical Limit,none,notalk,FAIL,75000000,68473360,213500000,101468129,92638183,288845939,3,281973360,381484122
2000,tt0161081,What Lies Beneath,none,ok,PASS,90000000,155464351,288693989,121761754,210329023,390576517,3,444158340,600905540
2000,tt0207201,What Women Want,disagree,notalk,FAIL,65000000,182805123,372100000,87939045,247318583,503417209,3,554905123,750735792
2000,tt0198021,Where the Heart Is,none,ok,PASS,15000000,33771174,40862054,20293626,45689304,55282615,3,74633228,100971919
2000,tt0190332,"Wo hu cang long (Crouching Tiger, Hidden Dragon)",none,ok,PASS,15000000,128067808,213200000,20293626,173264011,288440067,3,341267808,461704078
2000,tt0120903,X-Men,disagree,notalk,FAIL,75000000,157299717,296339717,101468129,212812106,400920487,3,453639434,613732593
1999,tt0147800,10 Things I Hate About You,none,ok,PASS,13000000,38177966,60414025,18180006,53390436,84486720,4,98591991,137877156
1999,tt0134273,8MM,none,notalk,FAIL,40000000,36443442,96398826,55938481,50964770,134810098,4,132842268,185774868
1999,tt0169547,American Beauty,none,ok,PASS,15000000,130058047,356258047,20976930,181881240,498213351,4,486316094,680094591
1999,tt0163651,American Pie,none,men,FAIL,12000000,101800948,234723148,16781544,142364760,328251410,4,336524096,470616170
1999,tt0122933,Analyze This,none,notalk,FAIL,30000000,106885658,176885658,41953861,149475534,247367876,4,283771316,396843410
1999,tt0166485,Anna and the King,none,men,FAIL,75000000,39251128,39251128,104884652,54891212,54891212,4,78502256,109782424
1999,tt0149691,Anywhere But Here,none,dubious,FAIL,23000000,18653615,18653615,32164627,26086372,26086372,4,37307230,52172744
1999,tt0145660,Austin Powers: The Spy Who Shagged Me,disagree,notalk,FAIL,35000000,206040085,310332636,48946171,288139235,433988407,4,516372721,722127642
1999,tt0120601,Being John Malkovich,none,ok,PASS,13000000,22858926,32382381,18180006,31967340,45285530,4,55241307,77252870
1999,tt0165643,Black and White,none,ok,PASS,10000000,5241315,5241315,13984620,7329780,7329780,4,10482630,14659560
1999,tt0181316,Blue Streak,none,notalk,FAIL,36000000,68208190,117448157,50344633,95386564,164246788,4,185656347,259633352
1999,tt0171804,Boys Don't Cry,disagree,ok,PASS,2000000,11540607,20741000,2796924,16139101,29005501,4,32281607,45144602
1999,tt0179116,But I'm a Cheerleader,none,ok,PASS,1200000,2205627,2629191,1678154,3084486,3676824,4,4834818,6761310
1999,tt0144814,Carrie 2: The Rage,none,ok,PASS,21000000,17760244,17760244,29367703,24837027,24837027,4,35520488,49674054
1999,tt0139134,Cruel Intentions,none,ok,PASS,11000000,38230075,75803716,15383082,53463308,106008618,4,114033791,159471926
1999,tt0144168,Dick,none,ok,PASS,13000000,6276869,6276869,18180006,8777963,8777963,4,12553738,17555926
1999,tt0120655,Dogma,disagree,dubious,FAIL,10000000,30651422,43948865,13984620,42864850,61460819,4,74600287,104325669
1999,tt0157503,Drop Dead Gorgeous,none,ok,PASS,10000000,10571408,10571408,13984620,14783713,14783713,4,21142816,29567426
1999,tt0126886,Election,none,ok,PASS,8500000,14943582,17202854,11886927,20898032,24057538,4,32146436,44955570
1999,tt0120663,Eyes Wide Shut,none,ok,PASS,65000000,55691208,86257553,90900032,77882040,120627912,4,141948761,198509952
1999,tt0137523,Fight Club,disagree,notalk,FAIL,65000000,37030102,100853753,90900032,51785192,141040144,4,137883855,192825336
1999,tt0155711,Flawless,none,notalk,FAIL,27000000,4485485,4485485,37758475,6272780,6272780,4,8970970,12545560
1999,tt0126916,For Love of the Game,none,men,FAIL,50000000,35188640,46112640,69923101,49209977,64486776,4,81301280,113696753
1999,tt0177789,Galaxy Quest,disagree,notalk,FAIL,45000000,71423726,90523726,62930791,99883369,126593993,4,161947452,226477362
1999,tt0172493,"Girl, Interrupted",none,ok,PASS,24000000,28871190,28871190,33563089,40375263,40375263,4,57742380,80750526
1999,tt0139239,Go!,none,ok,PASS,6500000,16875273,28383441,9090003,23599429,39693164,4,45258714,63292593
1999,tt0155776,Jawbreaker,none,ok,PASS,3000000,3076820,3076820,4195386,4302816,4302816,4,6153640,8605632
1999,tt0175880,Magnolia,disagree,notalk,FAIL,37000000,22450975,48446802,51743095,31396836,67751013,4,70897777,99147849
1999,tt0158811,Muppets From Space,none,ok,PASS,24000000,16304786,16304786,33563089,22801624,22801624,4,32609572,45603248
1999,tt0132347,Mystery Men,disagree,nowomen,FAIL,68000000,29762011,33462011,95095418,41621042,46795352,4,63224022,88416394
1999,tt0125439,Notting Hill,none,ok,PASS,42000000,116089678,363728226,58735405,162347007,508660113,4,479817904,671007120
1999,tt0151804,Office Space,none,notalk,FAIL,10000000,10827813,12827813,13984620,15142285,17939209,4,23655626,33081494
1999,tt0120784,Payback,none,notalk,FAIL,50000000,81526121,161626121,69923101,114011185,226027993,4,243152242,340039178
1999,tt0190641,Pocket Monsters: Mewtwo Strikes Back!,disagree,notalk,FAIL,30000000,85744662,163644662,41953861,119910654,228850846,4,249389324,348761500
1999,tt0129332,Ravenous,none,notalk,FAIL,12000000,2062406,2062406,16781544,2884196,2884196,4,4124812,5768392
1999,tt0162661,Sleepy Hollow,none,ok,PASS,70000000,101068340,207068340,97892342,141340236,289577211,4,308136680,430917447
1999,tt0158983,South Park: Bigger Longer & Uncut,disagree,dubious,FAIL,21000000,52037603,52037603,29367703,72772612,72772612,4,104075206,145545224
1999,tt0120915,Star Wars: Episode I - The Phantom Menace,none,ok,PASS,115000000,474544677,1007044677,160823133,663632711,1408313741,4,1481589354,2071946452
1999,tt0164912,Stuart Little,disagree,notalk,FAIL,105000000,140015224,298800000,146838513,195805974,417860454,4,438815224,613666428
1999,tt0120855,Tarzan,disagree,men,FAIL,145000000,171091819,448191819,202776994,239265412,626779240,4,619283638,866044652
1999,tt0120657,The 13th Warrior,disagree,dubious,FAIL,125000000,32698899,61698899,174807753,45728169,86283567,4,94397798,132011736
1999,tt0185937,The Blair Witch Project,none,ok,PASS,600000,140539099,248300000,839077,196538593,347238122,4,388839099,543776715
1999,tt0144117,The Boondock Saints,disagree,nowomen,FAIL,7000000,30471,411874,9789234,42613,575990,4,442345,618603
1999,tt0120689,The Green Mile,disagree,notalk,FAIL,60000000,136801374,290701374,83907722,191311527,406534833,4,427502748,597846360
1999,tt0171363,The Haunting,none,ok,PASS,80000000,91188905,180188905,111876962,127524221,251987342,4,271377810,379511563
1999,tt0129167,The Iron Giant,disagree,nowomen,FAIL,50000000,23159305,31333917,69923101,32387409,43819293,4,54493222,76206702
1999,tt0133093,The Matrix,disagree,ok,PASS,65000000,171479930,460279930,90900032,239808171,643684004,4,631759860,883492175
1999,tt0120616,The Mummy,none,notalk,FAIL,80000000,155385488,416385488,111876962,217300705,582299294,4,571770976,799599999
1999,tt0167404,The Sixth Sense,disagree,dubious,FAIL,40000000,293506292,672806292,55938481,410457404,940894052,4,966312584,1351351456
1999,tt0134119,The Talented Mr. Ripley,none,dubious,FAIL,40000000,81292135,128792135,55938481,113683964,180110910,4,210084270,293794874
1999,tt0144640,Three to Tango,none,notalk,FAIL,20000000,10570375,10570375,27969241,14782268,14782268,4,21140750,29564536
1999,tt0151568,Topsy-Turvy,none,ok,PASS,20000000,6201757,6201757,27969241,8672922,8672922,4,12403514,17345844
1999,tt0120363,Toy Story 2,disagree,notalk,FAIL,90000000,245852179,511358276,125861583,343814937,715115132,4,757210455,1058930069
1999,tt0120458,Virus,none,dubious,FAIL,75000000,14010690,30626690,104884652,19593418,42830263,4,44637380,62423681
1999,tt0120891,Wild Wild West,none,men,FAIL,175000000,113805681,221229335,244730855,159152923,309380824,4,335035016,468533747
1999,tt0131646,Wing Commander,none,men,FAIL,30000000,11578022,11578022,41953861,16191424,16191424,4,23156044,32382848
1998,tt0120577,54,none,notalk,FAIL,13000000,16757163,16757163,18578720,23948203,23948203,4,33514326,47896406
1998,tt0120623,A Bug's Life,none,ok,PASS,45000000,162798565,363095319,64310954,232660690,518911253,4,525893884,751571943
1998,tt0120586,American History X,disagree,men,FAIL,10000000,6719864,6719864,14291323,9603575,9603575,4,13439728,19207150
1998,tt0120591,Armageddon,none,notalk,FAIL,140000000,201578182,554600000,200078524,288081893,792596781,4,756178182,1080678674
1998,tt0120603,Beloved,none,ok,PASS,53000000,22852487,22852487,75744013,32659228,32659228,4,45704974,65318456
1998,tt0120611,Blade,none,notalk,FAIL,45000000,70141876,131237688,64310954,100242021,187556021,4,201379564,287798042
1998,tt0144120,Bride of Chucky,none,notalk,FAIL,25000000,32404188,50692188,35728308,46309872,72445844,4,83096376,118755716
1998,tt0118789,Buffalo '66,none,notalk,FAIL,1500000,2380606,2380606,2143698,3402201,3402201,4,4761212,6804402
1998,tt0118929,Dark City,disagree,notalk,FAIL,27000000,14435076,27257061,38586572,20629634,38953947,4,41692137,59583581
1998,tt0120647,Deep Impact,none,ok,PASS,80000000,140464664,349464664,114330585,200742590,499431243,4,489929328,700173833
1998,tt0134619,Disturbing Behavior,none,notalk,FAIL,15000000,17507368,17507368,21436985,25020345,25020345,4,35014736,50040690
1998,tt0127536,Elizabeth,none,ok,PASS,25000000,30082699,82150642,35728308,42992157,117404137,4,112233341,160396294
1998,tt0120660,Enemy of the State,none,notalk,FAIL,85000000,111549836,250649836,121476247,159419475,358211780,4,362199672,517631255
1998,tt0120631,Ever After,none,ok,PASS,26000000,65705772,65705772,37157440,93902242,93902242,4,131411544,187804484
1998,tt0120669,Fear and Loathing in Las Vegas,none,notalk,FAIL,18500000,10680275,13711903,26438948,15263526,19596124,4,24392178,34859650
1998,tt0154420,Festen (The Celebration),disagree,dubious,FAIL,1300000,1647780,1647780,1857872,2354896,2354896,4,3295560,4709792
1998,tt0162973,Get Real,none,men,FAIL,2000000,1152411,1152411,2858265,1646948,1646948,4,2304822,3293896
1998,tt0120685,Godzilla,none,dubious,FAIL,125000000,136314294,376000000,178641539,194811162,537353750,4,512314294,732164912
1998,tt0120694,Halloween H20: 20 Years Later,none,ok,PASS,17000000,55041738,55041738,24295249,78661926,78661926,4,110083476,157323852
1998,tt0147612,Happiness,none,ok,PASS,3000000,2746453,5746453,4287397,3925045,8212442,4,8492906,12137487
1998,tt0119313,Hope Floats,none,ok,PASS,30000000,60110313,81529000,42873969,85905591,116515728,4,141639313,202421319
1998,tt0147004,Little Voice,none,ok,PASS,6000000,4595000,21787233,8574794,6566863,31136839,4,26382233,37703702
1998,tt0120735,"Lock, Stock and Two Smoking Barrels",none,notalk,FAIL,1350000,3897569,28356188,1929329,5570142,40524745,4,32253757,46094887
1998,tt0120738,Lost in Space,none,ok,PASS,80000000,69117629,136047317,114330585,98778237,194429617,4,205164946,293207854
1998,tt0120749,Mercury Rising,none,notalk,FAIL,60000000,32983332,32983332,85747939,47137546,47137546,4,65966664,94275092
1998,tt0120762,Mulan,disagree,dubious,FAIL,90000000,120620254,303500000,128621908,172382303,433741657,4,424120254,606123960
1998,tt0120780,Out of Sight,none,men,FAIL,48000000,37562568,77562568,68598351,53681880,110847172,4,115125136,164529052
1998,tt0138704,Pi,none,men,FAIL,68000,3221152,4678513,97181,4603452,6686214,4,7899665,11289666
1998,tt0120791,Practical Magic,none,ok,PASS,60000000,46850558,68336997,85747939,66955646,97662611,4,115187555,164618257
1998,tt0119942,Primary Colors,none,ok,PASS,65000000,39017984,39017984,92893600,55761862,55761862,4,78035968,111523724
1998,tt0120800,Quest for Camelot,none,ok,PASS,40000000,22772500,38172500,57165293,32544916,54553553,4,60945000,87098469
1998,tt0128442,Rounders,none,notalk,FAIL,12000000,22921898,22921898,17149588,32758425,32758425,4,45843796,65516850
1998,tt0130827,Run Lola Run,disagree,notalk,FAIL,1750000,7267324,14533173,2500982,10385968,20769827,4,21800497,31155795
1998,tt0120812,Rush Hour,disagree,ok,PASS,35000000,141186864,245300000,50019631,201774709,350566156,4,386486864,552340865
1998,tt0128445,Rushmore,disagree,notalk,FAIL,10000000,17105219,19080435,14291323,24445621,27268466,4,36185654,51714087
1998,tt0120813,Safe Men,none,nowomen,FAIL,1000000,21210,21210,1429132,30312,30312,4,42420,60624
1998,tt0120815,Saving Private Ryan,none,nowomen,FAIL,65000000,216335085,485035085,92893600,309171460,693179313,4,701370170,1002350773
1998,tt0138097,Shakespeare in Love,none,ok,PASS,26000000,100317794,279500000,37157440,143367401,399442481,4,379817794,542809882
1998,tt0120828,Six Days Seven Nights,none,notalk,FAIL,80000000,74339294,164800000,114330585,106240687,235521005,4,239139294,341761692
1998,tt0120148,Sliding Doors,none,ok,PASS,6000000,11911200,58809149,8574794,17022681,84046055,4,70720349,101068736
1998,tt0120831,Slums of Beverly Hills,none,ok,PASS,5000000,5502773,5502773,7145662,7864191,7864191,4,11005546,15728382
1998,tt0122718,Small Soldiers,none,notalk,FAIL,40000000,55143823,71743823,57165293,78807819,102531416,4,126887646,181339235
1998,tt0120321,Smoke Signals,none,ok,PASS,2000000,6719300,7756617,2858265,9602769,11085232,4,14475917,20688001
1998,tt0120184,Sphere,none,notalk,FAIL,73000000,37068294,50168294,104326659,52975497,71697130,4,87236588,124672627
1998,tt0120844,Star Trek: Insurrection,none,ok,PASS,70000000,70187658,117800000,100039262,100307450,168351786,4,187987658,268659236
1998,tt0120686,Stepmom,none,ok,PASS,50000000,91137662,159745279,71456616,130247778,228297140,4,250882941,358544918
1998,tt0118661,The Avengers,none,ok,PASS,60000000,23385416,48585416,85747939,33420854,69434988,4,71970832,102855842
1998,tt0118715,The Big Lebowski,disagree,notalk,FAIL,15000000,17498804,46189568,21436985,25008106,66011004,4,63688372,91019110
1998,tt0133751,The Faculty,none,dubious,FAIL,15000000,40283321,40283321,21436985,57570196,57570196,4,80566642,115140392
1998,tt0120744,The Man in the Iron Mask,disagree,notalk,FAIL,35000000,56968169,56968169,50019631,81415051,81415051,4,113936338,162830102
1998,tt0120746,The Mask of Zorro,disagree,notalk,FAIL,65000000,93828745,233700000,92893600,134093691,333988221,4,327528745,468081912
1998,tt0120768,The Negotiator,none,notalk,FAIL,50000000,44705766,49105766,71456616,63890455,70178637,4,93811532,134069092
1998,tt0120794,The Prince of Egypt,disagree,notalk,FAIL,60000000,101413188,218600000,85747939,144932864,312408324,4,320013188,457341188
1998,tt0120108,The Proposition,none,men,FAIL,20000000,1903434,5313608,28582646,2720259,7593849,4,7217042,10314108
1998,tt0120863,The Thin Red Line,none,notalk,FAIL,52000000,36400491,36400491,74314880,52021118,52021118,4,72800982,104042236
1998,tt0120382,The Truman Show,disagree,notalk,FAIL,60000000,125618201,248400000,85747939,179525030,354996466,4,374018201,534521496
1998,tt0129387,There's Something About Mary,none,ok,PASS,22000000,176484651,360099999,31440911,252219917,514630544,4,536584650,766850461
1998,tt0146336,Urban Legend,none,ok,PASS,14000000,38116707,72571864,20007852,54473818,103714796,4,110688571,158188614
1998,tt0120877,Vampires (John Carpenter's),none,nowomen,FAIL,20000000,20268825,20268825,28582646,28966833,28966833,4,40537650,57933666
1998,tt0120879,Velvet Goldmine,none,men,FAIL,9000000,1053788,4861972,12862191,1506002,6948401,4,5915760,8454403
1998,tt0120890,Wild Things,disagree,men,FAIL,20000000,29795299,55576699,28582646,42581425,79426456,4,85371998,122007881
1998,tt0128853,You've Got Mail,none,ok,PASS,65000000,115821495,250800000,92893600,165524241,358426384,4,366621495,523950625
1997,tt0120133,A Simple Wish,none,ok,PASS,28000000,8165213,8165213,40634668,11849668,11849668,4,16330426,23699336
1997,tt0118570,Air Bud,none,notalk,FAIL,3000000,24646936,27788649,4353714,35768573,40327947,4,52435585,76096520
1997,tt0118571,Air Force One,none,notalk,FAIL,85000000,172956409,315268353,123355241,251000935,457529453,4,488224762,708530388
1997,tt0118583,Alien: Resurrection,none,ok,PASS,60000000,47795018,160700000,87074287,69361952,233213967,4,208495018,302575919
1997,tt0118617,Anastasia,none,ok,PASS,53000000,58403409,139801410,76915621,84757254,202885136,4,198204819,287642390
1997,tt0119822,As Good as It Gets,none,ok,PASS,50000000,148478011,314111923,72561906,215476950,455851198,4,462589934,671328148
1997,tt0118655,Austin Powers: International Man of Mystery,none,men,FAIL,18000000,53883989,67683989,26122286,78198499,98225585,4,121567978,176424084
1997,tt0118688,Batman & Robin,disagree,men,FAIL,125000000,107325195,238317814,181404766,155754415,345855898,4,345643009,501610313
1997,tt0118749,Boogie Nights,disagree,dubious,FAIL,15000000,26410771,43111725,21768572,38328318,62565379,4,69522496,100893697
1997,tt0118829,Cats Don't Dance,none,ok,PASS,32000000,3588602,3588602,46439620,5207916,5207916,4,7177204,10415832
1997,tt0118842,Chasing Amy,none,ok,PASS,250000,12006514,15155095,362810,17424311,21993652,4,27161609,39417963
1997,tt0128996,Cinderella,none,ok,PASS,2900000,85000000,85000000,4208591,123355241,123355241,4,170000000,246710482
1997,tt0118866,Clockwatchers,none,ok,PASS,2000000,537948,539961,2902476,780691,783612,4,1077909,1564303
1997,tt0118880,Con Air,disagree,notalk,FAIL,80000000,101117573,224117573,116099050,146745677,325247966,4,325235146,471993643
1997,tt0118883,Conspiracy Theory,none,men,FAIL,80000000,76118990,142783718,116099050,110466780,207213175,4,218902708,317679955
1997,tt0118884,Contact,none,ok,PASS,90000000,100920329,165900000,130611431,146459429,240760405,4,266820329,387219834
1997,tt0119080,Eve's Bayou,none,ok,PASS,5000000,14843425,14843425,7256191,21541344,21541344,4,29686850,43082688
1997,tt0119081,Event Horizon,none,ok,PASS,60000000,26673242,26673242,87074287,38709226,38709226,4,53346484,77418452
1997,tt0119114,Fever Pitch,none,ok,PASS,40000000,42071069,50071069,58049525,61055139,72665044,4,92142138,133720183
1997,tt0119137,Flubber,none,men,FAIL,80000000,92993801,177993801,116099050,134956149,258311390,4,270987602,393267539
1997,tt0119173,G.I. Jane,none,ok,PASS,50000000,48169156,48169156,72561906,69904916,69904916,4,96338312,139809832
1997,tt0119177,Gattaca,disagree,notalk,FAIL,36000000,12532777,12532777,52244573,18188044,18188044,4,25065554,36376088
1997,tt0119190,George of the Jungle,none,ok,PASS,55000000,105263257,174463257,79818097,152762052,253187730,4,279726514,405949782
1997,tt0119217,Good Will Hunting,disagree,nowomen,FAIL,10000000,138433435,225933435,14512381,200899879,327883215,4,364366870,528783094
1997,tt0119229,Grosse Pointe Blank,none,ok,PASS,15000000,28084357,31070412,21768572,40757090,45090566,4,59154769,85847656
1997,tt0119282,Hercules,disagree,ok,PASS,70000000,99112101,250700000,101586669,143835260,363825398,4,349812101,507660658
1997,tt0119345,I Know What You Did Last Summer,none,ok,PASS,17000000,72250091,125250091,24671048,104852087,181767707,4,197500182,286619794
1997,tt0119361,In the Company of Men,none,notalk,FAIL,25000,2883661,2883661,36281,4184879,4184879,4,5767322,8369758
1997,tt0119396,Jackie Brown,none,ok,PASS,12000000,39673162,74727492,17414858,57575205,108447385,4,114400654,166022590
1997,tt0119468,Kiss the Girls,none,men,FAIL,27000000,60527873,60527873,39183429,87840357,87840357,4,121055746,175680714
1997,tt0119488,L.A. Confidential,none,notalk,FAIL,35000000,64604977,110604977,50793334,93757206,160514159,4,175209954,254271365
1997,tt0119528,Liar Liar,disagree,notalk,FAIL,45000000,181410615,302710615,65305716,263270001,439305185,4,484121230,702575186
1997,tt0119654,Men in Black,none,notalk,FAIL,90000000,250690539,587790539,130611431,363811668,853024040,4,838481078,1216835708
1997,tt0119698,Mononoke-hime,none,ok,PASS,20000000,2374107,150350000,29024763,3445395,218193652,4,152724107,221639047
1997,tt0119707,Mortal Kombat: Annihilation,none,ok,PASS,30000000,35927406,51327406,43537144,52139221,74488288,4,87254812,126627509
1997,tt0417001,Must love Dogs,none,men,FAIL,35000000,43894863,58894863,50793334,63701899,85470471,4,102789726,149172370
1997,tt0119738,My Best Friend's Wedding,disagree,men,FAIL,46000000,126813153,298923419,66756954,184036082,433809062,4,425736572,617845144
1997,tt0124819,Orgazmo,none,notalk,FAIL,1000000,582024,627287,1451238,844655,910343,4,1209311,1754998
1997,tt0120082,Scream 2,none,ok,PASS,24000000,101363301,101363301,34829715,147102287,147102287,4,202726602,294204574
1997,tt0120094,Selena,none,ok,PASS,20000000,35450113,35450113,29024763,51446556,51446556,4,70900226,102893112
1997,tt0120152,Smilla's Sense of Snow,none,ok,PASS,35000000,2221994,2221994,50793334,3224642,3224642,4,4443988,6449284
1997,tt0120177,Spawn,none,ok,PASS,40000000,54979992,87949859,58049525,79789061,127636188,4,142929851,207425249
1997,tt0120201,Starship Troopers,none,ok,PASS,100000000,54768952,121100000,145123812,79482791,175744937,4,175868952,255227728
1997,tt0118971,The Devil's Advocate,none,ok,PASS,57000000,61007424,153007424,82720573,88536300,222050207,4,214014848,310586507
1997,tt0119116,The Fifth Element,disagree,notalk,FAIL,95000000,63570862,263900000,137867622,92256459,382981741,4,327470862,475238200
1997,tt0119174,The Game,none,notalk,FAIL,50000000,48265581,48265581,72561906,70044851,70044851,4,96531162,140089702
1997,tt0119567,The Lost World: Jurassic Park,none,dubious,FAIL,75000000,229086679,786686679,108842859,332459322,1141669701,4,1015773358,1474129023
1997,tt0119874,The Peacemaker,none,dubious,FAIL,50000000,41263140,62967368,72561906,59882642,91380645,4,104230508,151263287
1997,tt0119925,The Postman,none,notalk,FAIL,80000000,17650704,17650704,116099050,25615375,25615375,4,35301408,51230750
1997,tt0120338,Titanic,none,ok,PASS,200000000,658672302,2185672302,290247625,955890356,3171930973,4,2844344604,4127821329
1997,tt0120461,Volcano,none,ok,PASS,90000000,47546796,120100000,130611431,69001723,174293699,4,167646796,243295422
1996,tt0115591,August,none,dubious,FAIL,3400000,12636,12636,5049561,18767,18767,4,25272,37534
1996,tt0115736,Bound,none,ok,PASS,4500000,3802260,7011317,6683242,5646983,10412962,4,10813577,16059945
1996,tt0115759,Broken Arrow,none,nowomen,FAIL,65000000,70645997,148345997,96535720,104920957,220318272,4,218991994,325239229
1996,tt0115857,Chain Reaction,none,notalk,FAIL,55000000,21226204,60209334,81684071,31524414,89420791,4,81435538,120945205
1996,tt0116136,DragonHeart,none,men,FAIL,57000000,51364680,104364680,84654401,76285021,154998762,4,155729360,231283783
1996,tt0116191,Emma,none,ok,PASS,5900000,22231658,37831658,8762473,33017679,56186252,4,60063316,89203931
1996,tt0116225,Escape from L.A.,none,notalk,FAIL,50000000,25426861,25426861,74258246,37763082,37763082,4,50853722,75526164
1996,tt0116260,Eye for an Eye,none,ok,PASS,20000000,26792700,26792700,29703299,39791578,39791578,4,53585400,79583156
1996,tt0116282,Fargo,disagree,ok,PASS,7000000,24567751,51204567,10396154,36487162,76047227,4,75772318,112534389
1996,tt0116361,Freeway,none,ok,PASS,3000000,295493,295493,4455495,438856,438856,4,590986,877712
1996,tt0116367,From Dusk Till Dawn,none,notalk,FAIL,20000000,25728961,25728961,29703299,38211750,38211750,4,51457922,76423500
1996,tt0116477,Hamlet,disagree,notalk,FAIL,2000000,1577287,2419669,2970330,2342531,3593608,4,3996956,5936139
1996,tt0116493,Harriet the Spy,none,ok,PASS,13000000,26570048,26570048,19307144,39460903,39460903,4,53140096,78921806
1996,tt0116629,Independence Day,none,ok,PASS,75000000,306169255,817400878,111387369,454711839,1213975115,4,1123570133,1668686954
1996,tt0116705,Jingle All the Way,none,notalk,FAIL,60000000,60592389,129832389,89109896,89989691,192822510,4,190424778,282812201
1996,tt0116778,Kingpin,none,notalk,FAIL,25000000,25023424,32223424,37129123,37163912,47857099,4,57246848,85021011
1996,tt0116931,Love and Other Catastrophes,none,ok,PASS,250000,212285,743216,371291,315278,1103798,4,955501,1419076
1996,tt0116996,Mars Attacks!,none,ok,PASS,80000000,37771017,101371017,118813194,56096190,150552679,4,139142034,206648869
1996,tt0117060,Mission: Impossible,disagree,notalk,FAIL,80000000,180981886,457697994,118813194,268787949,679757008,4,638679880,948544957
1996,tt0117509,Romeo + Juliet,none,dubious,FAIL,14500000,46338728,147542381,21534891,68820654,219124769,4,193881109,287945423
1996,tt0117571,Scream,none,ok,PASS,15000000,103046663,173046663,22277474,153041290,257002834,4,276093326,410044124
1996,tt0117589,Secrets & Lies,none,ok,PASS,4500000,13417292,13417292,6683242,19926891,19926891,4,26834584,39853782
1996,tt0117603,Set It Off,none,ok,PASS,9000000,36049108,36049108,13366484,53538871,53538871,4,72098216,107077742
1996,tt0117705,Space Jam,none,notalk,FAIL,80000000,90463534,250200000,118813194,134353268,371588265,4,340663534,505941533
1996,tt0117723,Spy Hard,none,notalk,FAIL,18000000,26936265,26936265,26732969,40004796,40004796,4,53872530,80009592
1996,tt0117731,Star Trek: First Contact,disagree,ok,PASS,46000000,92027888,150000000,68317587,136676591,222774739,4,242027888,359451330
1996,tt0117765,Striptease,none,dubious,FAIL,50000000,33109743,113309743,74258246,49173429,168283656,4,146419486,217457085
1996,tt0117887,That Thing You Do!,none,ok,PASS,2500000,25857416,34557416,3712912,38402527,51323462,4,60414832,89725989
1996,tt0115798,The Cable Guy,none,notalk,FAIL,47000000,60240295,102825796,69802752,89466773,152713266,4,163066091,242180039
1996,tt0115963,The Craft,none,ok,PASS,15000000,24769466,55669466,22277474,36786742,82678338,4,80438932,119465080
1996,tt0116209,The English Patient,none,ok,PASS,35000000,78716374,231716374,51980772,116906798,344137032,4,310432748,461043830
1996,tt0116277,The Fan,none,notalk,FAIL,55000000,18582965,18582965,81684071,27598768,27598768,4,37165930,55197536
1996,tt0116313,The First Wives Club,none,ok,PASS,30000000,105489203,181489203,44554948,156668864,269541399,4,286978406,426210263
1996,tt0116421,The Glimmer Man,none,notalk,FAIL,45000000,20404841,36404841,66832422,30304554,54067193,4,56809682,84371747
1996,tt0116583,The Hunchback of Notre Dame,none,notalk,FAIL,100000000,100138851,325500000,148516493,148722709,483421183,4,425638851,632143892
1996,tt0116908,The Long Kiss Goodnight,disagree,notalk,FAIL,65000000,33447612,33447612,96535720,49675220,49675220,4,66895224,99350440
1996,tt0117057,The Mirror Has Two Faces,none,ok,PASS,42000000,41267469,41267469,62376927,61288998,61288998,4,82534938,122577996
1996,tt0117500,The Rock,none,notalk,FAIL,75000000,134069511,336069511,111387369,199115335,499118651,4,470139022,698233986
1996,tt0117951,Trainspotting,none,men,FAIL,3100000,16501785,24000785,4604011,24507872,35645124,4,40502570,60152996
1996,tt0117998,Twister,none,ok,PASS,88000000,241888385,495900000,130694514,359244145,736493287,4,737788385,1095737432
1996,tt0118113,Walking and Talking,none,ok,PASS,1000000,1287480,1615787,1485165,1912120,2399710,4,2903267,4311830
1996,tt0115856,When the Cat's Away,none,ok,PASS,300000,1652472,2525984,445549,2454193,3751503,4,4178456,6205696
1995,tt0112384,Apollo 13,disagree,ok,PASS,65000000,172070496,334100000,99370665,263057839,510765217,4,506170496,773823056
1995,tt0112401,Assassins,none,notalk,FAIL,50000000,30306268,83306268,76438973,46331600,127356911,4,113612536,173688511
1995,tt0112462,Batman Forever,none,notalk,FAIL,100000000,184031112,336529144,152877946,281342983,514478842,4,520560256,795821825
1995,tt0112471,Before Sunrise,none,nowomen,FAIL,2500000,5274005,5274005,3821949,8062791,8062791,4,10548010,16125582
1995,tt0112573,Braveheart,disagree,men,FAIL,72000000,75545647,209000000,110072121,115492633,319514907,4,284545647,435007540
1995,tt0112641,Casino,disagree,men,FAIL,52000000,42438300,110400000,79496532,64878801,168777252,4,152838300,233656053
1995,tt0112642,Casper,none,ok,PASS,55000000,100328194,282300000,84082870,153379682,431574441,4,382628194,584954123
1995,tt0112697,Clueless,none,ok,PASS,13700000,56598476,56598476,20944279,86526587,86526587,4,113196952,173053174
1995,tt0112715,Congo,none,nowomen,FAIL,50000000,81022333,152022333,76438973,123865278,232408620,4,233044666,356273898
1995,tt0112722,Copycat,none,dubious,FAIL,20000000,32051917,32051917,30575589,49000312,49000312,4,64103834,98000624
1995,tt0112864,Die Hard: With a Vengeance,none,notalk,FAIL,90000000,100012499,364480746,137590151,152897054,557210677,4,464493245,710107731
1995,tt0113101,Four rooms,none,notalk,FAIL,4000000,4301000,4301000,6115118,6575280,6575280,4,8602000,13150560
1995,tt0113321,Home for the holidays,none,ok,PASS,20000000,17468887,22119269,30575589,26706076,33815484,4,39588156,60521560
1995,tt0113497,Jumanji,none,ok,PASS,65000000,100458310,262758310,99370665,153578601,401699506,4,363216620,555278107
1995,tt0113749,Mallrats,disagree,notalk,FAIL,6100000,2108367,2108367,9325555,3223228,3223228,4,4216734,6446456
1995,tt0113855,Mortal Kombat,none,notalk,FAIL,20000000,70433227,122133227,30575589,107676871,186714768,4,192566454,294391639
1995,tt0114069,Outbreak,none,ok,PASS,50000000,67823573,67823573,76438973,103687285,103687285,4,135647146,207374570
1995,tt0114148,Pocahontas,disagree,ok,PASS,55000000,141579773,347100000,84082870,216444248,530639350,4,488679773,747083598
1995,tt0112130,Pride and Prejudice,disagree,ok,PASS,28000000,38372662,120918508,42805825,58663337,184857731,4,159291170,243521068
1995,tt0114319,Sabrina,none,ok,PASS,58000000,53458319,87100000,88669209,81725980,133156691,4,140558319,214882671
1995,tt0114323,Safe,none,ok,PASS,33000000,17142080,41495213,50449722,26206460,63437029,4,58637293,89643489
1995,tt0114369,Se7en,none,notalk,FAIL,30000000,100125643,328125643,45863384,153070026,501631742,4,428251286,654701768
1995,tt0114388,Sense and Sensibility,none,ok,PASS,16500000,42993774,134993774,25224861,65727998,206375709,4,177987548,272103707
1995,tt0114436,Showgirls,none,ok,PASS,40000000,20350754,37750754,61151178,31111815,57712577,4,58101508,88824392
1995,tt0114508,Species,none,dubious,FAIL,35000000,60054449,113354449,53507281,91810008,173293953,4,173408898,265103961
1995,tt0114614,Tank Girl,none,ok,PASS,25000000,4064333,4064333,38219486,6213469,6213469,4,8128666,12426938
1995,tt0112346,The American President,none,ok,PASS,62000000,60022813,107822813,94784326,91761643,164837302,4,167845626,256598945
1995,tt0112579,The Bridges of Madison County,none,ok,PASS,22000000,71516617,175516617,33633148,109333135,268326198,4,247033234,377659333
1995,tt0113416,The Incredibly True Adventures of Two Girls in Love,none,ok,PASS,250000,2210408,2477155,382195,3379226,3787024,4,4687563,7166250
1995,tt0113957,The Net,none,ok,PASS,22000000,50621733,110521733,33633148,77389465,168963355,4,161143466,246352820
1995,tt0114214,The Quick and the Dead,disagree,notalk,FAIL,32000000,18552460,18552460,48920943,28362620,28362620,4,37104920,56725240
1995,tt0114814,The Usual Suspects,none,notalk,FAIL,6000000,23341568,34449356,9172677,35684110,52665468,4,57790924,88349578
1995,tt0114709,Toy Story,disagree,notalk,FAIL,30000000,191780865,364530148,45863384,293190647,557286202,4,556311013,850476849
1995,tt0114746,Twelve Monkeys,none,notalk,FAIL,29000000,57141459,168841459,44334604,87356689,258121354,4,225982918,345478043
1995,tt0114898,Waterworld,disagree,nowomen,FAIL,175000000,88246220,264246220,267536405,134909008,403974193,4,352492440,538883201
1995,tt0114906,Welcome to the Dollhouse,none,ok,PASS,800000,4198137,5034794,1223024,6418026,7697090,4,9232931,14115116
1994,tt0109040,Ace Ventura: Pet Detective,none,men,FAIL,12000000,72217396,107217396,18859976,113501532,168509796,5,179434792,282011328
1994,tt0109254,Beverly Hills Cop III,none,nowomen,FAIL,50000000,42586861,119180938,78583235,66932266,187312473,5,161767799,254244739
1994,tt0109445,Clerks.,none,notalk,FAIL,27000,3073428,3894240,42435,4830398,6120440,5,6967668,10950838
1994,tt0109504,Crooklyn,none,ok,PASS,14000000,13024170,13024170,22003306,20469628,20469628,5,26048340,40939256
1994,tt0109686,Dumb & Dumber,none,men,FAIL,16000000,127175374,246400000,25146635,199877046,387258182,5,373575374,587135228
1994,tt0109707,Ed Wood,none,ok,PASS,18000000,5828466,5828466,28289965,9160394,9160394,5,11656932,18320788
1994,tt0109830,Forrest Gump,disagree,notalk,FAIL,55000000,329694499,679400525,86441558,518169206,1067789822,5,1009095024,1585959028
1994,tt0110322,Legends of the Fall,none,ok,PASS,30000000,66502573,160502573,47149941,104519746,252256228,5,227005146,356775974
1994,tt0110367,Little Women,none,ok,PASS,15000000,50003303,50003303,23574970,78588426,78588426,5,100006606,157176852
1994,tt0110622,Naked Gun 33 1/3: The Final Insult,none,men,FAIL,30000000,51041856,51041856,47149941,80220683,80220683,5,102083712,160441366
1994,tt0110857,Police Academy: Mission to Moscow,none,notalk,FAIL,10000000,126247,126247,15716647,198418,198418,5,252494,396836
1994,tt0110889,Priest,none,ok,PASS,60000000,29136626,84154026,94299882,45793007,132261912,5,113290652,178054919
1994,tt0110912,Pulp Fiction,disagree,ok,PASS,8000000,107928762,212928762,12573318,169627825,334652619,5,320857524,504280444
1994,tt0111257,Speed,none,ok,PASS,30000000,121248145,283200000,47149941,190561429,445095443,5,404448145,635656872
1994,tt0111282,Stargate,none,notalk,FAIL,55000000,71565669,196565669,86441558,112477236,308935323,5,268131338,421412559
1994,tt0111301,Street Fighter,none,ok,PASS,35000000,33423000,99423000,55008264,52529749,156259619,5,132846000,208789368
1994,tt0109446,The Client,none,ok,PASS,45000000,92115211,117615211,70724911,144774225,184851675,5,209730422,329625900
1994,tt0110074,The Hudsucker Proxy,none,notalk,FAIL,40000000,2816518,14938149,62866588,4426622,23477761,5,17754667,27904383
1994,tt0110357,The Lion King,disagree,notalk,FAIL,79300000,422780140,952880140,124633011,664468621,1497608078,5,1375660280,2162076699
1994,tt0110475,The Mask,none,notalk,FAIL,18000000,119920129,351620129,28289965,188474233,552628944,5,471540258,741103177
1994,tt0111070,The Santa Clause,none,notalk,FAIL,22000000,144833357,189800000,34576623,227629474,298301960,5,334633357,525931434
1994,tt0111143,The Shadow,none,nowomen,FAIL,40000000,31835600,31835600,62866588,50034889,50034889,5,63671200,100069778
1994,tt0111161,The Shawshank Redemption,disagree,nowomen,FAIL,25000000,28241469,28241469,39291617,44386120,44386120,5,56482938,88772240
1994,tt0111255,The Specialist,none,notalk,FAIL,45000000,57362581,57362581,70724911,90154744,90154744,5,114725162,180309488
1994,tt0111438,Timecop,none,notalk,FAIL,28000000,44853581,102053581,44006612,70494790,160394011,5,146907162,230888801
1994,tt0111503,True Lies,disagree,notalk,FAIL,100000000,146282411,365300000,157166470,229906901,574129115,5,511582411,804036016
1993,tt0106582,Cliffhanger,none,notalk,FAIL,65000000,84049211,255000000,104809829,135525899,411177020,5,339049211,546702919
1993,tt0106611,Cool Runnings,disagree,notalk,FAIL,14000000,68856263,155056263,22574425,111027894,250021852,5,223912526,361049746
1993,tt0106677,Dazed and Confused,disagree,ok,PASS,6900000,7950889,7950889,11125966,12820482,12820482,5,15901778,25640964
1993,tt0107007,Gettysburg,none,nowomen,FAIL,25000000,10731997,10731997,40311473,17304904,17304904,5,21463994,34609808
1993,tt0107048,Groundhog Day,disagree,men,FAIL,14600000,70906973,70906973,23541900,114334580,114334580,5,141813946,228669160
1993,tt0107120,Hocus Pocus,none,ok,PASS,28000000,39360491,39360491,45148849,63467174,63467174,5,78720982,126934348
1993,tt0107290,Jurassic Park,disagree,ok,PASS,63000000,395708305,1035626872,101584911,638063379,1669905770,5,1431335177,2307969149
1993,tt0107614,Mrs. Doubtfire,none,ok,PASS,25000000,219195051,441286003,40311473,353443011,711555544,5,660481054,1064998555
1993,tt0311648,Pieces of April,none,ok,PASS,300000,2528664,3590570,483738,4077367,5789647,5,6119234,9867014
1993,tt0108052,Schindler's List,none,ok,PASS,25000000,96067179,321365567,40311473,154904378,518188770,5,417432746,673093148
1993,tt0108255,Super Mario Bros.,none,dubious,FAIL,42000000,20844907,20844907,67723274,33611556,33611556,5,41689814,67223112
1993,tt0106226,The Age of Innocence,none,ok,PASS,34000000,32014993,32014993,54823603,51622860,51622860,5,64029986,103245720
1993,tt0106977,The Fugitive,none,men,FAIL,44000000,183875760,353715317,70948192,296492106,570351412,5,537591077,866843518
1993,tt0112389,The Princess and the Cobbler,none,nowomen,FAIL,24000000,669276,669276,38699014,1079180,1079180,5,1338552,2158360
1993,tt0107943,The Remains of the Day,disagree,nowomen,FAIL,15000000,22954968,63954968,24186884,37013943,103124758,5,86909936,140138701
1993,tt0108358,Tombstone,none,ok,PASS,25000000,56505065,56505065,40311473,91112095,91112095,5,113010130,182224190
1992,tt0104257,A Few Good Men,none,notalk,FAIL,33000000,141340178,236500000,54791459,234673774,392672121,5,377840178,627345895
1992,tt0104694,A League of Their Own,none,ok,PASS,40000000,107533925,132440066,66413889,178543655,219896498,5,239973991,398440153
1992,tt0103639,Aladdin,none,nowomen,FAIL,28000000,217350219,504050219,46489723,360876835,836898388,5,721400438,1197775223
1992,tt0103644,Alien 3,disagree,nowomen,FAIL,55000000,54927174,158500000,91319098,91198182,263165037,5,213427174,354363219
1992,tt0106308,Army of Darkness,disagree,men,FAIL,11000000,11502976,21502976,18263820,19098934,35702407,5,33005952,54801341
1992,tt0103776,Batman Returns,disagree,nowomen,FAIL,80000000,162833635,266824291,132827779,270360376,443020974,5,429657926,713381350
1992,tt0103893,Buffy the Vampire Slayer,none,ok,PASS,7000000,14231669,14231669,11622431,23629512,23629512,5,28463338,47259024
1992,tt0104070,Death Becomes Her,none,ok,PASS,55000000,58422650,149022650,91319098,97001885,247429345,5,207445300,344431230
1992,tt0104815,El Mariachi,none,nowomen,FAIL,7000,2040920,2041928,11622,3388636,3390310,5,4082848,6778946
1992,tt0104348,Glengarry Glen Ross,none,nowomen,FAIL,12500000,10725228,10725228,20754340,17807603,17807603,5,21450456,35615206
1992,tt0104412,Hero,none,notalk,FAIL,42000000,19487173,66787173,69734584,32355474,110889898,5,86274346,143245372
1992,tt0104431,Home Alone 2: Lost in New York,none,notalk,FAIL,20000000,173585516,358994850,33206945,288212232,596056107,5,532580366,884268339
1992,tt0104797,Malcolm X,none,dubious,FAIL,35000000,48169910,48169910,58112153,79978777,79978777,5,96339820,159957554
1992,tt0104952,My Cousin Vinny,none,notalk,FAIL,11000000,52929168,52929168,18263820,87880798,87880798,5,105858336,175761596
1992,tt0105236,Reservoir Dogs,none,nowomen,FAIL,1200000,2832029,2832029,1992417,4702152,4702152,5,5664058,9404304
1992,tt0104036,The Crying Game,none,men,FAIL,4000000,62546695,62546695,6641389,103849232,103849232,5,125093390,207698464
1992,tt0104868,The Mighty Ducks,none,notalk,FAIL,10000000,50752337,50752337,16603472,84266502,84266502,5,101504674,168533004
1992,tt0104940,The Muppet Christmas Carol,disagree,notalk,FAIL,12000000,27281507,27281507,19924167,45296775,45296775,5,54563014,90593550
1992,tt0105151,The Player,none,ok,PASS,8000000,21706101,28876702,13282778,36039665,47945352,5,50582803,83985017
1992,tt0105793,Wayne's World,none,notalk,FAIL,20000000,121697323,183097323,33206945,202059814,304005134,5,304794646,506064948
1991,tt0101414,Beauty and the Beast,disagree,ok,PASS,20000000,218951625,451421625,34216807,374591278,772310338,5,670373250,1146901616
1991,tt0101452,Bill & Ted's Bogus Journey,none,notalk,FAIL,20000000,37537675,37537675,34216807,64220970,64220970,5,75075350,128441940
1991,tt0102057,Hook,none,men,FAIL,70000000,119654823,300854823,119758826,204710301,514714575,5,420509646,719424876
1991,tt0102070,Hudson Hawk,none,ok,PASS,65000000,17218916,17218916,111204624,29458817,29458817,5,34437832,58917634
1991,tt0102798,Robin Hood: Prince of Thieves,none,dubious,FAIL,50000000,165493908,390500000,85542018,283133658,668083163,5,555993908,951216821
1991,tt0102943,Slacker,none,ok,PASS,23000,1227508,1227508,39349,2100070,2100070,5,2455016,4200140
1991,tt0102975,Star Trek VI: The Undiscovered Country,disagree,men,FAIL,27000000,74888996,96900000,46192690,128123117,165780431,5,171788996,293903548
1991,tt0103060,Teenage Mutant Ninja Turtles II: The Secret of the Ooze,none,ok,PASS,25000000,78656813,78656813,42771009,134569251,134569251,5,157313626,269138502
1991,tt0103064,Terminator 2: Judgement Day,none,dubious,FAIL,100000000,204859496,516816151,171084037,350481895,884189932,5,721675647,1234671827
1991,tt0101272,The Addams Family,none,ok,PASS,30000000,113502246,191502246,51325211,194184224,327629772,5,305004492,521813996
1991,tt0102510,The Naked Gun 2 1/2: The Smell of Fear,none,notalk,FAIL,23000000,86930411,86930411,39349328,148724056,148724056,5,173860822,297448112
1991,tt0102926,The Silence of the Lambs,disagree,ok,PASS,20000000,130726716,275726716,34216807,223652543,471724395,5,406453432,695376938
1991,tt0103247,White Fang,none,notalk,FAIL,14000000,34729091,34729091,23951765,59415931,59415931,5,69458182,118831862
1990,tt0099088,Back to the Future Part III,none,notalk,FAIL,40000000,87666629,243700000,71319016,156307443,434511105,5,331366629,590818548
1990,tt0099253,Child's Play 2,none,ok,PASS,13000000,26904572,34166572,23178680,47970190,60918157,5,61071144,108888347
1990,tt0099817,Dark Angel (I Come in Peace),none,nowomen,FAIL,7000000,4372561,4372561,12480828,7796169,7796169,5,8745122,15592338
1990,tt0099423,Die Hard 2,disagree,dubious,FAIL,70000000,117323878,239814025,124808278,209185588,427582507,5,357137903,636768095
1990,tt0099487,Edward Scissorhands,none,ok,PASS,20000000,53976987,53976987,35659508,96239640,96239640,5,107953974,192479280
1990,tt0099582,Flatliners,none,ok,PASS,26000000,61308153,61308153,46357360,109310929,109310929,5,122616306,218621858
1990,tt0099653,Ghost,disagree,men,FAIL,22000000,217631306,517600000,39225459,388031265,922868068,5,735231306,1310899333
1990,tt0099685,Goodfellas,disagree,men,FAIL,25000000,46743809,46743809,44574385,83343062,83343062,5,93487618,166686124
1990,tt0099785,Home Alone,disagree,men,FAIL,15000000,285761243,476684675,26744631,509505267,849917050,5,762445918,1359422317
1990,tt0100263,Nikita,none,ok,PASS,7000000,5017971,5017971,12480828,8946919,8946919,5,10035942,17893838
1990,tt0100403,Predator 2,none,men,FAIL,35000000,28317513,54768418,62404139,50489429,97650742,5,83085931,148140171
1990,tt0100405,Pretty Woman,none,ok,PASS,14000000,178406268,432645872,24961656,318093987,771396947,5,611052140,1089490934
1990,tt0099810,The Hunt for Red October,none,notalk,FAIL,30000000,120709866,200500000,53489262,215222722,357486568,5,321209866,572709290
1990,tt0100802,Total Recall,none,notalk,FAIL,125000000,58877969,198615996,222871925,104977970,354127435,5,257493965,459105405
1990,tt0100814,Tremors,none,ok,PASS,10000000,16667084,16667084,17829754,29717001,29717001,5,33334168,59434002
1989,tt0096874,Back to the Future Part II,none,ok,PASS,40000000,118450002,332000000,75183554,222637302,624023495,,450450002,846660797
1989,tt0096895,Batman,none,notalk,FAIL,35000000,251188924,411348924,65785609,472131898,773166847,,662537848,1245298745
1989,tt0096928,Bill & Ted's Excellent Adventure,none,men,FAIL,10000000,40485039,40485039,18795888,76095227,76095227,,80970078,152190454
1989,tt0097165,Dead Poets Society,none,notalk,FAIL,16400000,95860116,239500000,30825257,180177604,450161527,,335360116,630339131
1989,tt0097499,Henry V,none,ok,PASS,9000000,10161099,10161099,16916300,19098688,19098688,,20322198,38197376
1989,tt0097576,Indiana Jones and the Last Crusade,disagree,nowomen,FAIL,48000000,197171806,474171806,90220264,370601926,891248035,,671343612,1261849961
1989,tt0097742,Licence to Kill,none,men,FAIL,42000000,34667015,156167015,78942731,65159735,293529779,,190834030,358689514
1989,tt0097815,Major League,none,notalk,FAIL,11000000,49793054,49793054,20675477,93590469,93590469,,99586108,187180938
1989,tt0098206,Road House,none,notalk,FAIL,10000000,30050028,30050028,18795888,56481697,56481697,,60100056,112963394
1989,tt0098724,"Sex, Lies, and Videotape",disagree,men,FAIL,1200000,24741667,36741667,2255507,46504161,69059227,,61483334,115563388
1989,tt0098382,Star Trek V: The Final Frontier,none,notalk,FAIL,30000000,52210049,70200000,56387665,98133425,131947137,,122410049,230080562
1989,tt0096754,The Abyss,disagree,ok,PASS,70000000,54243125,54243125,131571219,101954772,101954772,,108486250,203909544
1989,tt0098519,Troop Beverly Hills,none,ok,PASS,18000000,7190505,7190505,33832599,13515193,13515193,,14381010,27030386
1989,tt0098546,UHF,none,notalk,FAIL,5000000,6157157,6157157,9397944,11572924,11572924,,12314314,23145848
1988,tt0094612,Action Jackson,none,notalk,FAIL,7000000,20257000,20257000,13787529,39899139,39899139,,40514000,79798278
1988,tt0094625,Akira,none,notalk,FAIL,8000000,19585,19585,15757176,38576,38576,,39170,77152
1988,tt0094721,Beetle Juice,none,ok,PASS,15000000,73326666,73326666,29544705,144427648,144427648,,146653332,288855296
1988,tt0092675,Bloodsport,none,notalk,FAIL,1500000,11806119,11806119,2954471,23253887,23253887,,23612238,46507774
1988,tt0094862,Child's Play,none,ok,PASS,9000000,33244684,44196684,17726823,65480292,87051866,,77441368,152532158
1988,tt0094947,Dangerous Liaisons,none,ok,PASS,14000000,34700000,34700000,27575058,68346751,68346751,,69400000,136693502
1988,tt0095016,Die Hard,disagree,ok,PASS,28000000,81350242,139109346,55150116,160231261,273996307,,220459588,434227568
1988,tt0095631,Midnight Run,none,men,FAIL,30000000,38413606,81613606,59089410,75661244,160749995,,120027212,236411239
1988,tt0095687,My Stepmother Is an Alien,none,ok,PASS,16000000,13854000,13854000,31514352,27287490,27287490,,27708000,54574980
1988,tt0095690,Mystic Pizza,none,ok,PASS,6000000,12793213,12793213,11817882,25198114,25198114,,25586426,50396228
1988,tt0095889,Poltergeist III,none,ok,PASS,9500000,14114000,14114000,18711647,27799598,27799598,,28228000,55599196
1988,tt0095953,Rain Man,none,notalk,FAIL,25000000,172825435,412800000,49241175,340405101,813070285,,585625435,1153475386
1988,tt0096061,Scrooged,none,ok,PASS,32000000,60328558,60328558,63028704,118825964,118825964,,120657116,237651928
1988,tt0095489,The Land Before Time,none,ok,PASS,12300000,48092846,81972846,24226658,94725930,161457571,,130065692,256183501
1988,tt0095497,The Last Temptation of Christ,none,men,FAIL,7000000,8373585,8373585,13787529,16493007,16493007,,16747170,32986014
1988,tt0096256,They Live,disagree,nowomen,FAIL,4000000,13000000,13000000,7878588,25605411,25605411,,26000000,51210822
1988,tt0096320,Twins,none,men,FAIL,15000000,111936388,216600000,29544705,220475172,426625542,,328536388,647100714
1988,tt0096438,Who Framed Roger Rabbit,none,notalk,FAIL,70000000,154112492,351500000,137875291,303547209,692330924,,505612492,995878133
1988,tt0096487,Young Guns,none,notalk,FAIL,13000000,44726644,44726644,25605411,88095701,88095701,,89453288,176191402
1987,tt0092644,Beverly Hills Cop II,none,notalk,FAIL,20000000,153665036,276665036,41007948,315074388,567273267,,430330072,882347655
1987,tt0092991,Evil Dead II,disagree,dubious,FAIL,3500000,5923044,5923044,7176391,12144594,12144594,,11846088,24289188
1987,tt0093010,Fatal Attraction,none,dubious,FAIL,14000000,156645693,320100000,28705563,321185920,656332204,,476745693,977518124
1987,tt0093105,"Good Morning, Vietnam",none,notalk,FAIL,13000000,123922370,123922370,26655166,254090104,254090104,,247844740,508180208
1987,tt0093177,Hellraiser,none,ok,PASS,1000000,14564000,14564000,2050397,29861988,29861988,,29128000,59723976
1987,tt0093409,Lethal Weapon,disagree,notalk,FAIL,15000000,65192350,120192350,30755961,133670224,246442080,,185384700,380112304
1987,tt0093773,Predator,none,nowomen,FAIL,18000000,59735548,98267558,36907153,122481612,201487544,,158003106,323969156
1987,tt0093818,Radio Days,none,notalk,FAIL,16000000,14792779,14792779,32806358,30331075,30331075,,29585558,60662150
1987,tt0093870,RoboCop,none,notalk,FAIL,120000000,54764805,221577330,246047687,112289613,454321579,,276342135,566611192
1987,tt0094012,Spaceballs,disagree,dubious,FAIL,22700000,38119483,38119483,46544021,78160088,78160088,,76238966,156320176
1987,tt0094074,Superman IV: The Quest for Peace,none,ok,PASS,17000000,11227824,11227824,34856756,23021501,23021501,,22455648,46043002
1987,tt0093389,The Last Emperor,none,dubious,FAIL,25000000,43984000,43984000,51259935,90184679,90184679,,87968000,180369358
1987,tt0093437,The Lost Boys,none,notalk,FAIL,8500000,32222567,32222567,17428378,66069067,66069067,,64445134,132138134
1987,tt0093779,The Princess Bride,disagree,men,FAIL,15000000,30857000,30857000,30755961,63269112,63269112,,61714000,126538224
1986,tt0090605,Aliens,disagree,ok,PASS,17000000,85160248,183316455,36104000,180860331,389321020,,268476703,570181351
1986,tt0090555,Crocodile Dundee,none,dubious,FAIL,5000000,174803506,328000000,10618824,371241520,696594829,,502803506,1067836349
1986,tt0091203,Highlander,disagree,ok,PASS,16000000,5900000,12900000,33980236,12530212,27396565,,18800000,39926777
1986,tt0091225,Howard The Duck,none,dubious,FAIL,30000000,16295774,16295774,63712942,34608390,34608390,,32591548,69216780
1986,tt0091419,Little Shop of Horrors,disagree,notalk,FAIL,30000000,38747385,38747385,63712942,82290329,82290329,,77494770,164580658
1986,tt0091738,Peggy Sue Got Married,none,ok,PASS,18000000,41382841,41382841,38227765,87887418,87887418,,82765682,175774836
1986,tt0091763,Platoon,none,nowomen,FAIL,6000000,137963328,137963328,12742588,293001649,293001649,,275926656,586003298
1986,tt0092005,Stand By Me,none,nowomen,FAIL,8000000,52287414,52287414,16990118,111046165,111046165,,104574828,222092330
1986,tt0090848,The Clan of the Cave Bear,none,ok,PASS,15000000,1953732,1953732,31856471,4149267,4149267,,3907464,8298534
1986,tt0092099,Top Gun,none,men,FAIL,15000000,179800601,356800601,31856471,381854174,757760530,,536601202,1139614704
1985,tt0088763,Back to the Future,disagree,notalk,FAIL,19000000,210609762,383874862,41136059,455981879,831110482,,594484624,1287092361
1985,tt0088846,Brazil,none,ok,PASS,15000000,9929135,9929135,32475836,21497131,21497131,,19858270,42994262
1985,tt0088944,Commando,none,notalk,FAIL,10000000,35073978,35073978,21650558,75937118,75937118,,70147956,151874236
1985,tt0088993,Day of the Dead,none,nowomen,FAIL,18000000,,,38971004,,,,,
1985,tt0089457,Ladyhawke,none,nowomen,FAIL,20000000,18400000,18400000,43301115,39837026,39837026,,36800000,79674052
1985,tt0089469,Legend,none,dubious,FAIL,25000000,15502112,15502112,54126394,33562937,33562937,,31004224,67125874
1985,tt0091578,My Beautiful Laundrette,none,men,FAIL,400000,,,866022,,,,,
1985,tt0089893,Red Sonja,none,ok,PASS,17900000,6905861,6905861,38754498,14951574,14951574,,13811722,29903148
1985,tt0089908,Return to Oz,none,ok,PASS,27000000,10618813,10618813,58456506,22990322,22990322,,21237626,45980644
1985,tt0088939,The Color Purple,none,ok,PASS,15000000,93589701,93589701,32475836,202626921,202626921,,187179402,405253842
1984,tt0087800,A nightmare on Elm Street,disagree,men,FAIL,35000000,63075011,117729621,78450540,141379105,263884353,,180804632,405263458
1984,tt0086879,Amadeus,disagree,ok,PASS,18000000,51973029,51973029,40345992,116494634,116494634,,103946058,232989268
1984,tt0086960,Beverly Hills Cop,none,nowomen,FAIL,15000000,234760478,316300000,33621660,526202467,708968739,,551060478,1235171206
1984,tt0086984,Body Double,none,men,FAIL,10000000,8801940,8801940,22414440,19729056,19729056,,17603880,39458112
1984,tt0087078,Conan the Destroyer,none,dubious,FAIL,18000000,26400000,26400000,40345992,59174122,59174122,,52800000,118348244
1984,tt0087182,Dune,disagree,dubious,FAIL,45000000,27447471,27447471,100864980,61521969,61521969,,54894942,123043938
1984,tt0087298,Friday the 13th Part IV: The Final Chapter,none,ok,PASS,2600000,32980880,32980880,5827754,73924796,73924796,,65961760,147849592
1984,tt0087332,Ghostbusters,disagree,notalk,FAIL,30000000,238632124,291632124,67243320,534880544,653677077,,530264248,1188557621
1984,tt0087363,Gremlins,disagree,notalk,FAIL,11000000,148168459,148168459,24655884,332111304,332111304,,296336918,664222608
1984,tt0087469,Indiana Jones and the Temple of Doom,none,nowomen,FAIL,28000000,179880271,333080271,62760432,403191555,746580777,,512960542,1149772332
1984,tt0087928,Police Academy,none,dubious,FAIL,4500000,81198894,81198894,10086498,182002774,182002774,,162397788,364005548
1984,tt0087995,Repo Man,none,men,FAIL,1500000,2300000,2300000,3362166,5155321,5155321,,4600000,10310642
1984,tt0088161,Splash,none,notalk,FAIL,8000000,62599495,62599495,17931552,140313263,140313263,,125198990,280626526
1984,tt0088170,Star Trek III: The Search for Spock,none,notalk,FAIL,18000000,76471046,87000000,40345992,171405568,195005629,,163471046,366411197
1984,tt0087538,The Karate Kid,none,ok,PASS,40000000,176591618,359091618,89657760,395820224,804883755,,535683236,1200703979
1984,tt0088247,The Terminator,disagree,men,FAIL,6400000,38019031,78019031,14345242,85217529,174875289,,116038062,260092818
1983,tt0085549,Flashdance,none,ok,PASS,7000000,90463574,201463574,16375486,211626424,471294841,,291927148,682921265
1983,tt0086190,Star Wars: Episode VI - Return of the Jedi,disagree,nowomen,FAIL,32500000,309205079,572700000,76029041,723340482,1339748672,,881905079,2063089154
1983,tt0086393,Superman III,none,ok,PASS,39000000,59950623,59950623,91234849,140245796,140245796,,119901246,280491592
1983,tt0086541,Videodrome,none,men,FAIL,5952000,2120439,2120439,13923842,4960460,4960460,,4240878,9920920
1983,tt0086567,WarGames,none,notalk,FAIL,12000000,74433837,74433837,28072261,174127177,174127177,,148867674,348254354
1982,tt0083658,Blade Runner,none,notalk,FAIL,28000000,32656328,33139618,67571504,78808471,79974780,,65795946,158783251
1982,tt0083722,Cat People,none,ok,PASS,12500000,7000000,21000000,30165850,16892876,50678628,,28000000,67571504
1982,tt0082198,Conan the Barbarian,none,notalk,FAIL,20000000,38264085,79114085,48265360,92341492,190923490,,117378170,283264982
1982,tt0083833,Diner,none,notalk,FAIL,5000000,12592907,12592907,12066340,30390060,30390060,,25185814,60780120
1982,tt0083866,E.T.: The Extra-Terrestrial,none,dubious,FAIL,10500000,435110554,792965326,25339314,1050038377,1913637848,,1228075880,2963676225
1982,tt0083929,Fast Times at Ridgemont High,none,men,FAIL,4500000,27092880,27092880,10859706,65382380,65382380,,54185760,130764760
1982,tt0083944,First Blood,none,nowomen,FAIL,14000000,47212904,125212904,33785752,113937390,302172295,,172425808,416109685
1982,tt0083972,Friday the 13th Part III,none,dubious,FAIL,2250000,36690067,36690067,5429853,88542965,88542965,,73380134,177085930
1982,tt0084516,Poltergeist,none,ok,PASS,10700000,74706019,121706019,25821968,180285645,293709241,,196412038,473994886
1982,tt0084522,Porky's,none,men,FAIL,4000000,109492484,109492484,9653072,264234708,264234708,,218984968,528469416
1982,tt0084726,Star Trek: The Wrath of Khan,disagree,dubious,FAIL,12000000,79912963,96800000,28959216,192851397,233604343,,176712963,426455740
1982,tt0083642,The Best Little Whorehouse in Texas,none,ok,PASS,20500000,69701637,69701637,49471994,168208730,168208730,,139403274,336417460
1982,tt0084805,Tootsie,disagree,notalk,FAIL,15000000,177200000,177200000,36199020,427631090,427631090,,354400000,855262180
1982,tt0084827,TRON,disagree,nowomen,FAIL,17000000,26918576,26918576,41025556,64961738,64961738,,53837152,129923476
1981,tt0082096,Das Boot,none,nowomen,FAIL,12000000,11487676,84970337,30742635,29430119,217684336,,96458013,247114455
1981,tt0082340,Escape from New York,disagree,nowomen,FAIL,6000000,25244700,25244700,15371317,64674049,64674049,,50489400,129348098
1981,tt0082418,Friday the 13th Part 2,none,notalk,FAIL,1250000,21722776,21722776,3202358,55651281,55651281,,43445552,111302562
1981,tt0082495,Halloween II,none,ok,PASS,2500000,25533818,25533818,6404716,65414737,65414737,,51067636,130829474
1981,tt0082509,Heavy Metal,none,notalk,FAIL,9300000,19571091,19571091,23825542,50138908,50138908,,39142182,100277816
1981,tt0082517,History of the World: Part I,disagree,notalk,FAIL,11000000,31672000,31672000,28180748,81140060,81140060,,63344000,162280120
1981,tt0082971,Raiders of the Lost Ark,disagree,nowomen,FAIL,20000000,248159971,389925971,51237724,635757611,998945973,,638085942,1634703584
1981,tt0083907,The Evil Dead,none,notalk,FAIL,375000,2400000,29400000,960707,6148527,75319455,,31800000,81467982
1981,tt0081633,Time Bandits,none,notalk,FAIL,12000000,37400000,37400000,30742635,95814545,95814545,,74800000,191629090
1980,tt0080339,Airplane!,none,dubious,FAIL,3500000,83453539,83453539,9897188,235987236,235987236,,166907078,471974472
1980,tt0080492,Can't Stop the Music,none,ok,PASS,20000000,2000000,2000000,56555357,5655536,5655536,,4000000,11311072
1980,tt0080716,Fame,none,ok,PASS,18000000,22455510,77956957,50899822,63498970,220444178,,100412467,283943148
1980,tt0080745,Flash Gordon,none,dubious,FAIL,35000000,27107960,27107960,98971875,76655018,76655018,,54215920,153310036
1980,tt0080761,Friday the 13th,disagree,men,FAIL,17000000,65002019,91700771,48072054,183810620,259308493,,156702790,443119113
1980,tt0080855,Heaven's Gate,none,nowomen,FAIL,44000000,3484331,3484331,124421786,9852879,9852879,,6968662,19705758
1980,tt0081375,Private Benjamin,none,ok,PASS,15000000,69847348,69847348,42416518,197512086,197512086,,139694696,395024172
1980,tt0081398,Raging Bull,none,notalk,FAIL,18000000,23380203,23380203,50899822,66113787,66113787,,46760406,132227574
1980,tt0081534,Somewhere in Time,none,men,FAIL,5100000,9709597,9709597,14421616,27456486,27456486,,19419194,54912972
1980,tt0080684,Star Wars: Episode V - The Empire Strikes Back,disagree,nowomen,FAIL,23000000,290271960,534171960,65038661,820821721,1510514303,,824443920,2331336024
1980,tt0081573,Superman II,none,dubious,FAIL,54000000,108185706,108185706,152699465,305924063,305924063,,216371412,611848126
1980,tt0080455,The Blues Brothers,none,notalk,FAIL,27000000,57229890,57229890,76349732,161832844,161832844,,114459780,323665688
1980,tt0080749,The Fog,none,ok,PASS,18000000,29511112,37048526,50899822,83450574,104764631,,66559638,188215205
1980,tt0081505,The Shining,disagree,men,FAIL,19000000,44017374,44017374,53727589,124470916,124470916,,88034748,248941832
1979,tt0078748,Alien,none,ok,PASS,9000000,80930630,203630630,28886103,259752278,653566146,,284561260,913318424
1979,tt0078788,Apocalypse Now,disagree,nowomen,FAIL,31500000,78800000,78800000,101101360,252913878,252913878,,157600000,505827756
1979,tt0079574,Moonraker,none,notalk,FAIL,31000000,70300000,210300000,99496576,225632559,674971936,,280600000,900604495
1979,tt0079945,Star Trek: The Motion Picture,none,notalk,FAIL,35000000,82258456,139000000,112334844,264014024,446129810,,221258456,710143834
1979,tt0078767,The Amityville Horror,none,ok,PASS,18500000,65233369,109175673,59376989,209370867,350406635,,174409042,559777502
1978,tt0077975,Animal House,none,men,FAIL,3000000,141600000,141600000,10712118,505611968,505611968,,283200000,1011223936
1978,tt0077402,Dawn of the Dead,none,nowomen,FAIL,28000000,58990765,103452875,99979768,210638678,369399800,,162443640,580038478
1978,tt0077405,Days of Heaven,none,ok,PASS,3000000,3446749,3660880,10712118,12307327,13071926,,7107629,25379253
1978,tt0077631,Grease,none,ok,PASS,6000000,181813770,387513770,21424236,649203517,1383697739,,569327540,2032901256
1978,tt0077651,Halloween,none,dubious,FAIL,15000000,58269151,77514401,53560590,208062006,276781136,,135783552,484843142
1978,tt0077713,I Spit on Your Grave,none,nowomen,FAIL,1750000,93051,1278471,6248735,332258,4565044,,1371522,4897302
1978,tt0078346,Superman,none,notalk,FAIL,55000000,134218018,300200000,196388829,479253080,1071925937,,434418018,1551179017
1978,tt0077416,The Deer Hunter,none,notalk,FAIL,15000000,50000000,50000000,53560590,178535299,178535299,,100000000,357070598
1977,tt0075784,A Bridge Too Far,none,notalk,FAIL,26000000,50800000,50800000,99921804,195231833,195231833,,101600000,390463666
1977,tt0075686,Annie Hall,none,ok,PASS,4000000,38251425,38251425,15372585,147005823,147005823,,76502850,294011646
1977,tt0075860,Close Encounters of the Third Kind,none,notalk,FAIL,20000000,166000000,337700000,76862926,637962288,1297830510,,503700000,1935792798
1977,tt0074486,Eraserhead,none,nowomen,FAIL,100000,7000000,7000000,384315,26902024,26902024,,14000000,53804048
1977,tt0076141,High Anxiety,none,notalk,FAIL,3400000,31063038,31063038,13066697,119379800,119379800,,62126076,238759600
1977,tt0076245,Julia,none,ok,PASS,6000000,65108,1365108,23058878,250220,5246310,,1430216,5496530
1977,tt0076759,Star Wars,none,notalk,FAIL,11000000,460998007,797900000,42274609,1771682790,3066446442,,1258898007,4838129232
1976,tt0074156,Assault on Precinct 13,none,notalk,FAIL,30000000,20040895,36040895,122754817,82003880,147473116,,56081790,229476996
1976,tt0074512,Family Plot,none,ok,PASS,3000000,13200000,13200000,12275482,54012120,54012120,,26400000,108024240
1976,tt0074812,Logan's Run,none,men,FAIL,7000000,25000000,25000000,28642791,102295681,102295681,,50000000,204591362
1976,tt0074958,Network,none,ok,PASS,3800000,23689877,23689877,15548943,96934884,96934884,,47379754,193869768
1976,tt0075148,Rocky,none,notalk,FAIL,1000000,117235147,225000000,4091827,479705967,920661128,,342235147,1400367095
1976,tt0075222,Silent Movie,none,notalk,FAIL,4400000,36145695,36145695,18004040,147901939,147901939,,72291390,295803878
1976,tt0075249,Sparkle,none,ok,PASS,10000000,24397469,24660323,40918272,99830228,100905781,,49057792,200736009
1976,tt0075314,Taxi Driver,none,notalk,FAIL,1000000,28262574,28262574,4091827,115645570,115645570,,56525148,231291140
1975,tt0072684,Barry Lyndon,none,notalk,FAIL,11000000,20000000,20000000,47609104,86562007,86562007,,40000000,173124014
1975,tt0073195,Jaws,none,notalk,FAIL,12000000,260000000,470700000,51937204,1125306085,2037236823,,730700000,3162542908
1975,tt0071853,Monty Python and the Holy Grail,none,men,FAIL,400000,3427696,5028948,1731240,14835412,21765791,,8456644,36601203
1975,tt0073486,One Flew Over the Cuckoo's Nest,none,men,FAIL,4400000,108981275,108981275,19043641,471681892,471681892,,217962550,943363784
1975,tt0073629,The Rocky Horror Picture Show,disagree,dubious,FAIL,1200000,139876417,139876417,5193720,605399166,605399166,,279752834,1210798332
1974,tt0071222,Black Christmas,none,ok,PASS,9000000,16235738,16235738,42513535,76693179,76693179,,32471476,153386358
1974,tt0071230,Blazing Saddles,none,notalk,FAIL,2600000,119500000,119500000,12281688,564485269,564485269,,239000000,1128970538
1974,tt0071360,The Conversation,none,notalk,FAIL,1600000,4420000,4420000,7557962,20878869,20878869,,8840000,41757738
1974,tt0071562,The Godfather: Part II,none,ok,PASS,13000000,57300000,57300000,61408439,270669505,270669505,,114600000,541339010
1974,tt0072271,The Texas Chain Saw Massacre,none,notalk,FAIL,140000,26572439,26572439,661322,125520924,125520924,,53144878,251041848
1974,tt0072308,The Towering Inferno,none,notalk,FAIL,140000,26572439,26572439,661322,125520924,125520924,,53144878,251041848
1974,tt0072431,Young Frankenstein,none,men,FAIL,2800000,86300000,86300000,13226433,407657562,407657562,,172600000,815315124
1973,tt0069704,American Graffiti,none,men,FAIL,777000,115000000,140000000,4074506,603047833,734145189,,255000000,1337193022
1973,tt0068699,High Plains Drifter,none,notalk,FAIL,15700000,15700000,15700000,82329139,82329139,82329139,,31400000,164658278
1973,tt0070707,Sleeper,none,notalk,FAIL,2000000,18344729,18344729,10487788,96197818,96197818,,36689458,192395636
1973,tt0070047,The Exorcist,none,ok,PASS,12000000,204868002,402735134,62926730,1074306128,2111900435,,607603136,3186206563
1973,tt0070735,The Sting,none,notalk,FAIL,5500000,159616327,159616327,28841418,837011132,837011132,,319232654,1674022264
1972,tt0068156,1776,none,notalk,FAIL,4000000,,,22288557,,,,,
1972,tt0069089,Pink Flamingos,none,ok,PASS,12000,413802,413802,66866,2305762,2305762,,827604,4611524
1972,tt0068646,The Godfather,disagree,notalk,FAIL,7000000,134966411,268500000,39004975,752051643,1496119403,,403466411,2248171046
1971,tt0067065,Escape from the Planet of the Apes,none,notalk,FAIL,2500000,12300000,12300000,14386286,70780525,70780525,,24600000,141561050
1971,tt0067741,Shaft,none,notalk,FAIL,53012938,70327868,107190108,305063707,404702718,616827003,,177517976,1021529721
1971,tt0067800,Straw Dogs,none,notalk,FAIL,25000000,10324441,11253821,143862856,59412143,64760273,,21578262,124172416
1971,tt0067116,The French Connection,none,notalk,FAIL,2200000,41158757,41158757,12659931,236848653,236848653,,82317514,473697306
1971,tt0067992,Willy Wonka & the Chocolate Factory,disagree,men,FAIL,3000000,4000000,4000000,17263543,23018057,23018057,,8000000,46036114
1970,tt0065466,Beyond the Valley of the Dolls,none,ok,PASS,1000000,9000000,9000000,5997631,53978683,53978683,,18000000,107957366
